"","gridcode_vec","diversity_vec","area_vec","Prob","area_ha","cum_area_ha"
"307",5809,1126,490000,0.825,49,49
"288",7331,1418,490000,0.825,49,98
"3770",28412,-47,1e+06,0.6,100,198
"5537",285,-932,1190000,0.3,119,317
"3595",30468,-139,4950000,0.6,495,812
"5552",63,-697,1190000,0.3,119,931
"3548",30472,-294,8e+05,0.6,80,1011
"541",33601,720,4550000,0.775,455,1466
"355",39936,1119,7e+05,0.825,70,1536
"862",27186,597,560000,0.775,56,1592
"1845",6643,286,2060000,0.65,206,1798
"2981",33945,-342,2890000,0.6,289,2087
"1080",343,990,490000,0.775,49,2136
"39",9132,2009,3700000,0.9,370,2506
"2477",37128,-152,560000,0.6,56,2562
"2897",34296,-335,3750000,0.6,375,2937
"2012",41149,446,8e+05,0.65,80,3017
"4505",35893,-552,1e+06,0.3,100,3117
"6069",11896,-1065,560000,0.1,56,3173
"4543",35617,-849,1430000,0.3,143,3316
"2467",17272,-400,560000,0.6,56,3372
"1726",30798,340,2630000,0.65,263,3635
"1272",34731,120,1990000,0.65,199,3834
"5154",30997,-671,2090000,0.3,209,4043
"1786",21203,44,6e+06,0.65,600,4643
"4085",24111,-118,640000,0.6,64,4707
"2044",4364,354,8e+05,0.65,80,4787
"4133",38404,-293.5,1400000,0.6,140,4927
"1902",42136,251,1360000,0.65,136,5063
"4071",24271,-224,2120000,0.6,212,5275
"2271",24818,448,1e+06,0.65,100,5375
"1977",28268,101,8e+05,0.65,80,5455
"5416",26163,-997.5,2890000,0.3,289,5744
"2947",33975,-78.5,6160000,0.6,616,6360
"5454",1528,-660,7e+05,0.3,70,6430
"1217",13961,23.5,1050000,0.65,105,6535
"1562",32489,103,1190000,0.65,119,6654
"2375",24019,201,3830000,0.65,383,7037
"893",20345,789,1e+06,0.775,100,7137
"4821",11199,-573.666666666667,2650000,0.3,265,7402
"1803",29489,330,490000,0.65,49,7451
"315",5161,1254,490000,0.825,49,7500
"5578",37999,-1275,560000,0.1,56,7556
"1587",9293,24.8,3450000,0.65,345,7901
"2199",1875,289,7e+05,0.65,70,7971
"6523",38642,-1006,640000,0.1,64,8035
"1097",38581,573,9e+05,0.775,90,8125
"3560",30956,-317,5140000,0.6,514,8639
"1003",39818,554,1530000,0.775,153,8792
"6111",11595,-1145,4720000,0.1,472,9264
"748",28949,578,2500000,0.775,250,9514
"5310",28419,-635,7380000,0.3,738,10252
"545",33427,987,4450000,0.775,445,10697
"3323",42817,-400,7e+05,0.6,70,10767
"1943",41908,165,640000,0.65,64,10831
"2295",39625,106,1190000,0.65,119,10950
"2749",35097,-309,7e+05,0.6,70,11020
"5322",5122,-604,1200000,0.3,120,11140
"2323",635,122,560000,0.65,56,11196
"1495",32949,56,8e+05,0.65,80,11276
"1195",14226,105,1430000,0.65,143,11419
"4980",10168,-876.5,2e+06,0.3,200,11619
"2365",24040,201,490000,0.65,49,11668
"782",41724,794,1500000,0.775,150,11818
"2210",1854,289,8e+05,0.65,80,11898
"18",25242,2539,1e+06,0.925,100,11998
"1021",39716,854,1e+06,0.775,100,12098
"2699",13997,-106,2310000,0.6,231,12329
"2845",12509,-180,3850000,0.6,385,12714
"1407",10928,54,1290000,0.65,129,12843
"5048",9365,-625,3060000,0.3,306,13149
"3458",42557,-251,4560000,0.6,456,13605
"3926",22664,-123,8e+05,0.6,80,13685
"5098",8784,-553,9e+05,0.3,90,13775
"326",26942,1076,7350000,0.825,735,14510
"184",35541,1050,490000,0.825,49,14559
"5360",27494,-878,560000,0.3,56,14615
"4146",38115,-652,560000,0.3,56,14671
"2538",36756,-297,7e+05,0.6,70,14741
"75",35193,1546.5,1430000,0.85,143,14884
"121",29902,1647,560000,0.85,56,14940
"3573",30888,-469,6800000,0.6,680,15620
"822",28018,587,720000,0.775,72,15692
"1",17771,3152,640000,0.95,64,15756
"4627",13050,-641,3560000,0.3,356,16112
"5541",204,-508,640000,0.3,64,16176
"1311",34282,219,3190000,0.65,319,16495
"714",6372,639,490000,0.775,49,16544
"2332",38937,277,1700000,0.65,170,16714
"1287",12213,354,1120000,0.65,112,16826
"1963",5493,259,7e+05,0.65,70,16896
"4034",24746,-48,1e+06,0.6,100,16996
"5714",43947,-1199,640000,0.1,64,17060
"2048",40801,62,7e+05,0.65,70,17130
"3219",32848,-449,7e+05,0.6,70,17200
"5536",38646,-959,1600000,0.3,160,17360
"530",33681,831,560000,0.775,56,17416
"966",22341,585,8e+05,0.775,80,17496
"4599",13442,-983,8e+05,0.3,80,17576
"1039",24338,762,720000,0.775,72,17648
"2292",24371,187,720000,0.65,72,17720
"5423",1890,-511,1440000,0.3,144,17864
"1248",35203,39,1e+06,0.65,100,17964
"391",24283,1351,8e+05,0.825,80,18044
"3776",28410,-62,490000,0.6,49,18093
"2886",12070,-7.66666666666667,2800000,0.6,280,18373
"4732",34154,-907,1190000,0.3,119,18492
"3384",31809,-288,560000,0.6,56,18548
"301",6032,1167,560000,0.825,56,18604
"2279",39617,2,1190000,0.65,119,18723
"5448",39887,-740,560000,0.3,56,18779
"2264",25060,49,490000,0.65,49,18828
"448",13943,938,490000,0.775,49,18877
"55",4953,2340,490000,0.9,49,18926
"3745",5782,-500,8e+05,0.6,80,19006
"5182",30512,-609,640000,0.3,64,19070
"859",27189,818,640000,0.775,64,19134
"1081",38789,681,8910000,0.775,891,20025
"270",42556,1354,1700000,0.825,170,20195
"418",17250,709,560000,0.775,56,20251
"167",14737,1006,7e+05,0.825,70,20321
"1076",24099,791,1960000,0.775,196,20517
"3938",19369,-33.3333333333333,2630000,0.6,263,20780
"730",29110,511.5,3450000,0.775,345,21125
"1663",31335,188,1e+06,0.65,100,21225
"528",21482,720,560000,0.775,56,21281
"1576",9456,351,9e+05,0.65,90,21371
"2027",27487,460,8e+05,0.65,80,21451
"294",29429,1138.5,10660000,0.825,1066,22517
"2709",43613,-136,8e+05,0.6,80,22597
"1398",43119,12.5,2190000,0.65,219,22816
"2815",12465,-287,3600000,0.6,360,23176
"3111",33279,-134,1120000,0.6,112,23288
"2359",24080,317.5,1290000,0.65,129,23417
"2711",13755,-175,1500000,0.6,150,23567
"4476",35986,-778,1360000,0.3,136,23703
"4968",32985,-753,560000,0.3,56,23759
"2714",13911,-496,3190000,0.6,319,24078
"3040",33480,-466,2700000,0.6,270,24348
"1087",24051,990,2400000,0.775,240,24588
"3898",3435,-3,1620000,0.6,162,24750
"2171",40355,449,1e+06,0.65,100,24850
"3607",29861,-32,1e+06,0.6,100,24950
"1480",32935,79,9210000,0.65,921,25871
"28",12700,2031,1190000,0.9,119,25990
"3229",32809,-424,560000,0.6,56,26046
"5432",25848,-617,1400000,0.3,140,26186
"1543",32802,426,1690000,0.65,169,26355
"1088",24000,650,1750000,0.775,175,26530
"941",2050,738,560000,0.775,56,26586
"1781",7007,451,1e+06,0.65,100,26686
"2042",27608,291,1360000,0.65,136,26822
"2807",12645,-236,640000,0.6,64,26886
"2590",23831,-16,490000,0.6,49,26935
"2918",34178,-4,4650000,0.6,465,27400
"2286",24732,331,3190000,0.65,319,27719
"497",11888,678.333333333333,3040000,0.775,304,28023
"5683",17461,-1060,1680000,0.1,168,28191
"6295",30591,-1067,1260000,0.1,126,28317
"2988",33829,-150,1e+06,0.6,100,28417
"853",4455,833,7e+05,0.775,70,28487
"5204",7364,-845,1260000,0.3,126,28613
"3763",28743,-311,1360000,0.6,136,28749
"5281",5862,-532,490000,0.3,49,28798
"662",30799,864,1530000,0.775,153,28951
"2102",26555,393.5,2870000,0.65,287,29238
"2623",43732,-199,560000,0.6,56,29294
"854",27179,833,560000,0.775,56,29350
"3931",26229,-11,810000,0.6,81,29431
"950",40151,607.333333333333,2600000,0.775,260,29691
"873",4144,897,490000,0.775,49,29740
"1257",34885,216,490000,0.65,49,29789
"52",41569,2379,7e+05,0.9,70,29859
"3122",10661,-360,1520000,0.6,152,30011
"6008",13363,-1119,1050000,0.1,105,30116
"156",39210,1922,1800000,0.85,180,30296
"1643",31994,126,4580000,0.65,458,30754
"2041",4409,190,560000,0.65,56,30810
"646",31330,959,2500000,0.775,250,31060
"1247",43626,360,3690000,0.65,369,31429
"3011",43138,-101,490000,0.6,49,31478
"2083",3646,175,490000,0.65,49,31527
"2420",18293,-468,490000,0.6,49,31576
"5526",38726,-891,1700000,0.3,170,31746
"5517",459,-725,630000,0.3,63,31809
"4570",35355,-958.6,7700000,0.3,770,32579
"5421",2147,-893,7e+05,0.3,70,32649
"2743",43604,-319,2500000,0.6,250,32899
"2122",2953,205,8e+05,0.65,80,32979
"2772",35172,-404,2240000,0.6,224,33203
"335",40618,1446,5200000,0.825,520,33723
"1074",24189,647,5760000,0.775,576,34299
"1598",32070,279,980000,0.65,98,34397
"4315",36837,-699,8e+05,0.3,80,34477
"1875",6343,286,1890000,0.65,189,34666
"928",40392,566,1500000,0.775,150,34816
"1556",32456,304,2690000,0.65,269,35085
"3373",31879,-187,640000,0.6,64,35149
"4329",36784,-522.666666666667,2820000,0.3,282,35431
"2582",44375,-42,490000,0.6,49,35480
"3811",41297,-447,640000,0.6,64,35544
"712",6351,671,1260000,0.775,126,35670
"4959",32994,-591,560000,0.3,56,35726
"170",14298,1292,1260000,0.825,126,35852
"2760",13277,-114,1260000,0.6,126,35978
"1810",29815,421,1200000,0.65,120,36098
"3702",42181,-321.333333333333,1890000,0.6,189,36287
"1124",17754,84,490000,0.65,49,36336
"2329",634,122,2800000,0.65,280,36616
"1958",42012,357,7e+05,0.65,70,36686
"3428",42622,-84,1190000,0.6,119,36805
"3240",32723,-214.333333333333,2540000,0.6,254,37059
"751",42062,801,1e+06,0.775,100,37159
"4094",410,-443,1820000,0.6,182,37341
"1642",42647,460,8e+05,0.65,80,37421
"1820",42211,400,560000,0.65,56,37477
"2998",33628,-21,1400000,0.6,140,37617
"3274",10008,-55,2190000,0.6,219,37836
"2263",1231,49,7e+05,0.65,70,37906
"3648",42232,-32,1990000,0.6,199,38105
"2225",25853,443.5,1490000,0.65,149,38254
"3353",9143,-422.5,1600000,0.6,160,38414
"3630",6935,-231.666666666667,1920000,0.6,192,38606
"686",29910,758,3200000,0.775,320,38926
"3615",29939,-1,7e+05,0.6,70,38996
"2735",13452,-140,1260000,0.6,126,39122
"3143",33694,-170,1200000,0.6,120,39242
"4574",13581,-927,560000,0.3,56,39298
"1759",7265,394,1e+06,0.65,100,39398
"3830",27890,-163,3450000,0.6,345,39743
"875",26970,647,3250000,0.775,325,40068
"4103",38736,-346,1190000,0.6,119,40187
"925",22576,700,560000,0.775,56,40243
"4487",14434,-912,8e+05,0.3,80,40323
"4054",39399,-12,560000,0.6,56,40379
"958",2000,646,1260000,0.775,126,40505
"1148",36541,23,1e+06,0.65,100,40605
"2893",12220,-80,4420000,0.6,442,41047
"957",44208,546.5,2450000,0.775,245,41292
"266",42562,1070,1e+06,0.825,100,41392
"5396",26631,-813,3840000,0.3,384,41776
"5",22419,3087,9140000,0.95,914,42690
"3946",2314,-458,1700000,0.6,170,42860
"733",6088,517,7e+05,0.775,70,42930
"800",5456,658,8e+05,0.775,80,43010
"1842",6472,388,8e+05,0.65,80,43090
"6092",11617,-1134.5,7920000,0.1,792,43882
"4343",16307,-967,980000,0.3,98,43980
"1847",42147,344,8e+05,0.65,80,44060
"3465",8739,-46,640000,0.6,64,44124
"3488",8126,-435,720000,0.6,72,44196
"783",41701,794,1e+06,0.775,100,44296
"594",9790,782,8e+05,0.775,80,44376
"2317",650,115,560000,0.65,56,44432
"1492",32868,161,7e+05,0.65,70,44502
"308",5516,1296,8e+05,0.825,80,44582
"1025",39648,854,490000,0.775,49,44631
"1920",6067,383,7e+05,0.65,70,44701
"5411",19385,-921,1490000,0.3,149,44850
"697",6845,533.25,3380000,0.775,338,45188
"1004",25509,941,3630000,0.775,363,45551
"1042",39201,503,640000,0.775,64,45615
"3902",26551,-260,2390000,0.6,239,45854
"2840",12575,-493,7e+05,0.6,70,45924
"1168",36257,109.5,1460000,0.65,146,46070
"358",25717,1114,8e+05,0.825,80,46150
"299",28964,1210,490000,0.825,49,46199
"2338",38902,178,560000,0.65,56,46255
"2611",14572,-484,640000,0.6,64,46319
"2429",44130,-96,2650000,0.6,265,46584
"3504",30905,-424,1920000,0.6,192,46776
"5373",40778,-619,8e+05,0.3,80,46856
"3289",32372,-320,1280000,0.6,128,46984
"183",43628,1039,7e+05,0.825,70,47054
"5211",7122,-778,1e+06,0.3,100,47154
"2150",26397,173,8310000,0.65,831,47985
"2497",36940,-307,560000,0.6,56,48041
"1592",9255,19,7e+05,0.65,70,48111
"482",34948,861.666666666667,5050000,0.775,505,48616
"1689",8296,388,9e+05,0.65,90,48706
"3983",25972,-285,7e+05,0.6,70,48776
"6849",10242,-1702,1e+06,0.05,100,48876
"2625",43729,-269,8e+05,0.6,80,48956
"2474",17304,-300,490000,0.6,49,49005
"567",10192,783,3380000,0.775,338,49343
"604",32342,809,2750000,0.775,275,49618
"2862",43398,-130,8e+05,0.6,80,49698
"2234",25814,31.5,1560000,0.65,156,49854
"731",6144,509,1700000,0.775,170,50024
"3945",40352,-149,1e+06,0.6,100,50124
"3899",26414,-411,720000,0.6,72,50196
"1400",11064,6,1190000,0.65,119,50315
"2773",13018,-58,490000,0.6,49,50364
"1201",14136,307,1600000,0.65,160,50524
"3777",29243,-386,490000,0.6,49,50573
"5918",14462,-1001,9e+05,0.1,90,50663
"961",40115,517.5,2730000,0.775,273,50936
"1730",30646,329,9e+05,0.65,90,51026
"1339",21556,196,1830000,0.65,183,51209
"2465",17463,-254,560000,0.6,56,51265
"572",10211,969,8e+05,0.775,80,51345
"243",21379,1282.5,1260000,0.825,126,51471
"2500",17147,-118,3910000,0.6,391,51862
"3416",31483,-223,560000,0.6,56,51918
"3728",6138,-248,3060000,0.6,306,52224
"3598",30060,-449,4110000,0.6,411,52635
"2161",26248,332,1190000,0.65,119,52754
"2672",35717,-281,1700000,0.6,170,52924
"171",14287,1178.5,1690000,0.825,169,53093
"3658",29567,-21,1200000,0.6,120,53213
"2452",37434,-167,640000,0.6,64,53277
"3721",29055,-386,1360000,0.6,136,53413
"2719",13616,-184,8e+05,0.6,80,53493
"151",1372,1671,8e+05,0.85,80,53573
"4344",36614,-719,490000,0.3,49,53622
"1659",31810,392,2400000,0.65,240,53862
"523",33761,569,490000,0.775,49,53911
"1108",18587,247,1490000,0.65,149,54060
"5156",30884,-597,560000,0.3,56,54116
"3247",10247,-333,8e+05,0.6,80,54196
"1957",41859,250,8e+05,0.65,80,54276
"2788",12751,-114,8e+05,0.6,80,54356
"1749",7533,394,7e+05,0.65,70,54426
"3044",10817,-319.5,1200000,0.6,120,54546
"2648",14314,-400,560000,0.6,56,54602
"3812",41179,-141,640000,0.6,64,54666
"3787",28354,-249,1360000,0.6,136,54802
"2812",34751,-81.5,2070000,0.6,207,55009
"3304",32488,-163,1700000,0.6,170,55179
"557",10477,830,9e+05,0.775,90,55269
"3391",31897,-51,5590000,0.6,559,55828
"599",9655,744,1360000,0.775,136,55964
"4123",38651,-158,1700000,0.6,170,56134
"1685",31243,34,1050000,0.65,105,56239
"1280",12283,303,7e+05,0.65,70,56309
"1487",10132,43,1750000,0.65,175,56484
"1077",38794,681,490000,0.775,49,56533
"2684",35932,-195,6480000,0.6,648,57181
"674",7141,599.5,980000,0.775,98,57279
"1829",29989,208,6080000,0.65,608,57887
"2053",27316,398,2990000,0.65,299,58186
"1402",33576,414,8e+05,0.65,80,58266
"3418",31525,-341,490000,0.6,49,58315
"2880",34577,-143,1680000,0.6,168,58483
"4035",39622,-370,7e+05,0.6,70,58553
"1411",21452,444.5,2680000,0.65,268,58821
"2524",16428,-261,4170000,0.6,417,59238
"2946",43235,-376,1500000,0.6,150,59388
"5174",8156,-875,560000,0.3,56,59444
"1658",31545,482.5,4690000,0.65,469,59913
"411",24104,1413,2760000,0.825,276,60189
"5173",8087,-571,7790000,0.3,779,60968
"2607",43791,-61,6020000,0.6,602,61570
"320",27538,1091,7e+05,0.825,70,61640
"2290",39428,357,720000,0.65,72,61712
"3319",32540,-11,7e+05,0.6,70,61782
"2376",23973,279,2100000,0.65,210,61992
"1770",29795,233.5,1560000,0.65,156,62148
"269",42693,1191,3910000,0.825,391,62539
"351",25922,1134,1360000,0.825,136,62675
"724",42114,536,630000,0.775,63,62738
"3413",31544,-46,560000,0.6,56,62794
"2077",26755,104,1260000,0.65,126,62920
"616",42794,812,1460000,0.775,146,63066
"2974",11274,-384,560000,0.6,56,63122
"3362",42782,-191,2800000,0.6,280,63402
"1654",8861,363,490000,0.65,49,63451
"717",21113,950,980000,0.775,98,63549
"2372",38702,111,1e+06,0.65,100,63649
"3789",41548,-272,1e+06,0.6,100,63749
"1839",6564,6,1530000,0.65,153,63902
"1197",35935,223,1750000,0.65,175,64077
"459",13916,505,2310000,0.775,231,64308
"112",7629,1975,560000,0.85,56,64364
"4088",524,-128,1750000,0.6,175,64539
"44",8311,2002,560000,0.9,56,64595
"5513",39120,-631,2410000,0.3,241,64836
"1578",9414,86,8e+05,0.65,80,64916
"1814",6773,367,1200000,0.65,120,65036
"3359",42707,-393,1700000,0.6,170,65206
"2999",11067,-458.333333333333,2960000,0.6,296,65502
"14",1878,2972,7e+05,0.925,70,65572
"3041",10982,-243,8e+05,0.6,80,65652
"5106",23705,-722,560000,0.3,56,65708
"1507",32858,57,1360000,0.65,136,65844
"3470",31096,-410,560000,0.6,56,65900
"1188",14654,27,640000,0.65,64,65964
"5431",1720,-706,8e+05,0.3,80,66044
"356",25808,1358,1700000,0.825,170,66214
"31",42906,2034,1460000,0.9,146,66360
"3920",19536,-478,8e+05,0.6,80,66440
"3065",33402,-420,8e+05,0.6,80,66520
"707",6471,501,560000,0.775,56,66576
"774",44261,672.5,6700000,0.775,670,67246
"1184",36231,200,6560000,0.65,656,67902
"2409",18217,-163,1400000,0.6,140,68042
"1226",13947,205,8e+05,0.65,80,68122
"3404",8708,-323,1e+06,0.6,100,68222
"559",42928,957,2470000,0.775,247,68469
"551",21421,572,3750000,0.775,375,68844
"2541",15729,-295,2170000,0.6,217,69061
"4038",24683,-366,1700000,0.6,170,69231
"6897",42417,-1866,560000,0.05,56,69287
"2753",13532,-375,560000,0.6,56,69343
"2318",39044,115,1190000,0.65,119,69462
"549",10571,572,7e+05,0.775,70,69532
"634",8931,699,8e+05,0.775,80,69612
"1266",34869,100,2440000,0.65,244,69856
"934",40278,615,490000,0.775,49,69905
"2480",17256,-217,1e+06,0.6,100,70005
"3693",6323,-77,7e+05,0.6,70,70075
"3294",32549,-174,5780000,0.6,578,70653
"3343",32067,-35,1540000,0.6,154,70807
"3130",44316,-358.333333333333,2930000,0.6,293,71100
"3238",32761,-432,7e+05,0.6,70,71170
"861",4244,597,640000,0.775,64,71234
"2925",11732,-478,2250000,0.6,225,71459
"1029",1094,996,2260000,0.775,226,71685
"3987",1732,-131,7e+05,0.6,70,71755
"623",31893,554,2e+06,0.775,200,71955
"3313",42811,-8,9180000,0.6,918,72873
"3550",7574,-241,560000,0.6,56,72929
"3236",10091,-26,7e+05,0.6,70,72999
"4810",33675,-814,8e+05,0.3,80,73079
"3258",32731,-58,8e+05,0.6,80,73159
"2780",12904,-134,490000,0.6,49,73208
"4284",17125,-700,2200000,0.3,220,73428
"398",24235,1044,2790000,0.825,279,73707
"4631",34931,-866,1260000,0.3,126,73833
"576",32816,510,490000,0.775,49,73882
"4693",12412,-690.2,4410000,0.3,441,74323
"2715",13790,-433,2440000,0.6,244,74567
"1651",31630,48.5,2260000,0.65,226,74793
"3822",41239,-273,560000,0.6,56,74849
"1604",32165,201,1920000,0.65,192,75041
"1702",8095,157,9e+05,0.65,90,75131
"2799",12695,-498,8e+05,0.6,80,75211
"954",40143,504,1190000,0.775,119,75330
"994",25898,741,8e+05,0.775,80,75410
"2970",11432,-434.666666666667,1980000,0.6,198,75608
"3110",10581,-145,490000,0.6,49,75657
"4719",12000,-773,7e+05,0.3,70,75727
"1213",35692,286,490000,0.65,49,75776
"2955",11459,-63,7e+05,0.6,70,75846
"5408",40605,-732,3450000,0.3,345,76191
"1205",35896,388,3300000,0.65,330,76521
"82",34496,1571.5,3050000,0.85,305,76826
"476",13236,509,560000,0.775,56,76882
"26",35353,2403,7e+05,0.9,70,76952
"2934",11533,-57,1260000,0.6,126,77078
"192",13918,1206.5,1190000,0.825,119,77197
"5446",25560,-895,490000,0.3,49,77246
"2863",12009,-357,7e+05,0.6,70,77316
"1079",38888,890,7e+05,0.775,70,77386
"2594",14827,-15,7e+05,0.6,70,77456
"146",24928,1674,560000,0.85,56,77512
"779",28752,544,6320000,0.775,632,78144
"4395",23849,-634,8e+05,0.3,80,78224
"2602",36196,-484,560000,0.6,56,78280
"2899",34322,-290,9e+05,0.6,90,78370
"2556",15414,-42,1520000,0.6,152,78522
"3494",31087,-387.5,3700000,0.6,370,78892
"3086",33329,-284.5,1990000,0.6,199,79091
"191",35469,1257,3560000,0.825,356,79447
"3042",10796,-477,560000,0.6,56,79503
"5092",31555,-734,490000,0.3,49,79552
"887",26718,620,7e+05,0.775,70,79622
"1119",37681,167,8e+05,0.65,80,79702
"5063",31713,-992,490000,0.3,49,79751
"687",29844,729,7e+05,0.775,70,79821
"2830",12764,-302.25,7910000,0.6,791,80612
"1922",5907,231,1e+06,0.65,100,80712
"2016",41107,391,1190000,0.65,119,80831
"900",26471,953,8e+05,0.775,80,80911
"4520",35686,-725,1050000,0.3,105,81016
"2621",36032,-342,560000,0.6,56,81072
"2187",40172,473,7e+05,0.65,70,81142
"4226",37501,-504,3280000,0.3,328,81470
"4874",33300,-560,7e+05,0.3,70,81540
"2203",40119,382,2e+06,0.65,200,81740
"3892",3185,-443,560000,0.6,56,81796
"3202",32897,-259.2,3210000,0.6,321,82117
"3596",30085,-479,7e+05,0.6,70,82187
"669",30168,753,3480000,0.775,348,82535
"2335",24265,448,7e+05,0.65,70,82605
"4442",36204,-723,1190000,0.3,119,82724
"4606",35155,-915,8e+05,0.3,80,82804
"478",13017,690,630000,0.775,63,82867
"3556",8016,-252,1350000,0.6,135,83002
"5328",28035,-693,4810000,0.3,481,83483
"5415",2132,-784,1e+06,0.3,100,83583
"1431",33126,442.333333333333,2090000,0.65,209,83792
"1178",43741,218.5,1130000,0.65,113,83905
"4045",975,-91,630000,0.6,63,83968
"3208",42925,-414,7e+05,0.6,70,84038
"6195",33067,-1158,640000,0.1,64,84102
"6164",33248,-1244,2290000,0.1,229,84331
"66",39351,2098,1260000,0.9,126,84457
"3412",8676,-351,1190000,0.6,119,84576
"2482",37100,-234,2500000,0.6,250,84826
"615",9325,812,1120000,0.775,112,84938
"3058",43075,-422,1190000,0.6,119,85057
"188",13576,1257,490000,0.825,49,85106
"1519",32732,104.5,2260000,0.65,226,85332
"268",21293,1241,2260000,0.825,226,85558
"1438",10633,461,1e+06,0.65,100,85658
"3738",42044,-154,3850000,0.6,385,86043
"3467",31075,-391.333333333333,3350000,0.6,335,86378
"2754",35308,-165,7e+05,0.6,70,86448
"1780",29705,451,7e+05,0.65,70,86518
"2183",26147,130,7e+05,0.65,70,86588
"843",27589,655,2060000,0.775,206,86794
"2265",1174,375.5,1260000,0.65,126,86920
"239",42938,1111,1190000,0.825,119,87039
"168",14650,1278,1850000,0.825,185,87224
"3519",30704,-221,2480000,0.6,248,87472
"2175",26211,7,3750000,0.65,375,87847
"739",42176,526,1190000,0.775,119,87966
"4511",14072,-685,630000,0.3,63,88029
"2514",16762,-270.5,1490000,0.6,149,88178
"2962",11449,-143,1700000,0.6,170,88348
"5243",42177,-598,7e+05,0.3,70,88418
"6223",32768,-1089,2980000,0.1,298,88716
"1983",5267,75,630000,0.65,63,88779
"6012",13492,-1337,2400000,0.1,240,89019
"1552",9748,358,1e+06,0.65,100,89119
"232",10275,1279,720000,0.825,72,89191
"5490",39630,-577,490000,0.3,49,89240
"5101",8793,-588,1e+06,0.3,100,89340
"2369",331,139,560000,0.65,56,89396
"1675",31155,118.5,1120000,0.65,112,89508
"228",10341,1279,640000,0.825,64,89572
"543",33357,987,2690000,0.775,269,89841
"4056",769,-498,1260000,0.6,126,89967
"1011",25143,776,560000,0.775,56,90023
"1071",38873,764,2060000,0.775,206,90229
"1811",29655,193,1360000,0.65,136,90365
"3730",42138,-85,6700000,0.6,670,91035
"1276",34654,271,1360000,0.65,136,91171
"2470",37206,-366,490000,0.6,49,91220
"1500",32847,174.5,1560000,0.65,156,91376
"2236",25582,26,490000,0.65,49,91425
"3909",22873,-104,2760000,0.6,276,91701
"1366",11382,265,490000,0.65,49,91750
"1134",37053,19,1800000,0.65,180,91930
"125",29497,1503,2550000,0.85,255,92185
"1465",10244,329,720000,0.65,72,92257
"1396",43166,232,1500000,0.65,150,92407
"706",21129,517,1700000,0.775,170,92577
"2513",36906,-26,7e+05,0.6,70,92647
"4319",16444,-860.5,1990000,0.3,199,92846
"1424",10568,147,490000,0.65,49,92895
"2345",38967,73,1700000,0.65,170,93065
"4104",409,-430,490000,0.6,49,93114
"2343",38898,219,1260000,0.65,126,93240
"1572",9569,122,1360000,0.65,136,93376
"4610",13074,-780,8e+05,0.3,80,93456
"1711",8112,233,8e+05,0.65,80,93536
"1279",34519,421,560000,0.65,56,93592
"3933",40513,-107,3190000,0.6,319,93911
"3574",7909,-317,2e+06,0.6,200,94111
"3084",33332,-122,1190000,0.6,119,94230
"4939",33133,-725,2e+06,0.3,200,94430
"297",21097,1275,7e+05,0.825,70,94500
"2411",18317,-420,1e+06,0.6,100,94600
"894",40654,950,1e+06,0.775,100,94700
"4072",39054,-380.5,2200000,0.6,220,94920
"2844",12284,-61,2390000,0.6,239,95159
"923",26242,716,3800000,0.775,380,95539
"945",40196,504,1e+06,0.775,100,95639
"1262",43514,117,1520000,0.65,152,95791
"990",1829,932,2260000,0.775,226,96017
"5025",9831,-919,8e+05,0.3,80,96097
"5611",18072,-1055,560000,0.1,56,96153
"5177",8058,-737,1200000,0.3,120,96273
"1715",30764,122,640000,0.65,64,96337
"2900",11770,-290,720000,0.6,72,96409
"766",28771,801,2700000,0.775,270,96679
"833",41178,589,2990000,0.775,299,96978
"2843",34699,-494,2060000,0.6,206,97184
"5527",308,-979,1500000,0.3,150,97334
"597",32440,800,490000,0.775,49,97383
"1372",33870,44,6680000,0.65,668,98051
"2702",13777,-2,1690000,0.6,169,98220
"2690",14102,-229,1990000,0.6,199,98419
"765",28810,603,1760000,0.775,176,98595
"2118",2989,181.5,1340000,0.65,134,98729
"4653",13311,-529.5,1440000,0.3,144,98873
"2705",13663,-189,560000,0.6,56,98929
"5528",24013,-974,1e+06,0.3,100,99029
"50",28965,2391,7e+05,0.9,70,99099
"2212",40060,77,490000,0.65,49,99148
"4082",437,-466,490000,0.6,49,99197
"438",36155,733,4980000,0.775,498,99695
"5112",42508,-760.5,1330000,0.3,133,99828
"2919",34140,-11,3530000,0.6,353,100181
"703",29487,752,1800000,0.775,180,100361
"904",26440,785,720000,0.775,72,100433
"3123",33264,-87.5,3460000,0.6,346,100779
"2024",27513,398,1e+06,0.65,100,100879
"6309",29888,-1140,8e+05,0.1,80,100959
"2854",12253,-373,7e+05,0.6,70,101029
"540",33390,705,560000,0.775,56,101085
"2476",17283,-305.5,1750000,0.6,175,101260
"2941",11496,-286,1e+06,0.6,100,101360
"683",8127,601,7e+05,0.775,70,101430
"761",41909,548,560000,0.775,56,101486
"960",40137,592,3210000,0.775,321,101807
"455",13927,839,1360000,0.775,136,101943
"274",8224,1066,490000,0.825,49,101992
"1253",13456,216,560000,0.65,56,102048
"1391",33769,385,1890000,0.65,189,102237
"3668",6757,-399.5,1400000,0.6,140,102377
"725",29308,555,8e+05,0.775,80,102457
"2552",36444,-439,630000,0.6,63,102520
"189",35609,1122,2560000,0.825,256,102776
"2088",26613,62,7e+05,0.65,70,102846
"2968",33787,-92,3240000,0.6,324,103170
"4824",33557,-598,630000,0.3,63,103233
"1824",6685,340,560000,0.65,56,103289
"3975",26051,-285,1440000,0.6,144,103433
"3636",6821,-160,7e+05,0.6,70,103503
"6415",3436,-1254,7e+05,0.1,70,103573
"409",38852,1130,4980000,0.825,498,104071
"3156",42944,-211,2130000,0.6,213,104284
"4058",39079,-493,9e+05,0.6,90,104374
"4708",12075,-719.5,2860000,0.3,286,104660
"1788",7033,158.5,2260000,0.65,226,104886
"1300",12026,118,7e+05,0.65,70,104956
"905",2942,870,560000,0.775,56,105012
"4000",1507,-348,1690000,0.6,169,105181
"3803",28090,-200,630000,0.6,63,105244
"2676",14141,-23,7e+05,0.6,70,105314
"3708",29262,-296,2650000,0.6,265,105579
"4801",33924,-929,2360000,0.3,236,105815
"2437",37457,-458.666666666667,1990000,0.6,199,106014
"635",8862,840.333333333333,2760000,0.775,276,106290
"4060",630,-351,490000,0.6,49,106339
"5153",31028,-609,2420000,0.3,242,106581
"3399",8936,-292,2800000,0.6,280,106861
"1634",32051,184.5,1900000,0.65,190,107051
"2331",38928,277,8e+05,0.65,80,107131
"1967",28422,489,1190000,0.65,119,107250
"3664",7023,-84.3333333333333,3180000,0.6,318,107568
"986",25975,929,1990000,0.775,199,107767
"4771",33991,-960,3690000,0.3,369,108136
"3340",42724,-393,560000,0.6,56,108192
"2586",15045,-15,1e+06,0.6,100,108292
"1086",23982,791,7e+05,0.775,70,108362
"240",32945,1271.33333333333,10770000,0.825,1077,109439
"1332",11795,120,560000,0.65,56,109495
"338",2252,1129,7e+05,0.825,70,109565
"401",39032,1380,5130000,0.825,513,110078
"1858",29757,57,5740000,0.65,574,110652
"2660",14447,-49,1200000,0.6,120,110772
"2720",13666,-113,8e+05,0.6,80,110852
"3197",10229,-339,490000,0.6,49,110901
"3733",28857,-308,490000,0.6,49,110950
"2396",38160,-461,9e+05,0.6,90,111040
"5189",30364,-916.333333333333,1960000,0.3,196,111236
"2692",14020,-348,2060000,0.6,206,111442
"4628",34947,-773.5,2050000,0.3,205,111647
"1789",29780,378,630000,0.65,63,111710
"2254",25154,415,640000,0.65,64,111774
"3147",44319,-189,2260000,0.6,226,112000
"2060",26923,191,8e+05,0.65,80,112080
"1650",42636,352,7e+05,0.65,70,112150
"4847",11050,-512,2920000,0.3,292,112442
"735",42045,536,9e+05,0.775,90,112532
"4098",38731,-282,490000,0.6,49,112581
"757",21076,542,3160000,0.775,316,112897
"2167",2355,52.75,6240000,0.65,624,113521
"5523",38799,-522,2e+06,0.3,200,113721
"2208",1832,423,560000,0.65,56,113777
"4362",44398,-880,8e+05,0.3,80,113857
"458",43616,574,2990000,0.775,299,114156
"256",32289,1436,1750000,0.825,175,114331
"1043",24348,780,2090000,0.775,209,114540
"3099",33214,-265,560000,0.6,56,114596
"1451",10496,190,720000,0.65,72,114668
"148",24876,1595,5190000,0.85,519,115187
"2321",24242,65,490000,0.65,49,115236
"1868",6485,210.333333333333,3310000,0.65,331,115567
"3536",42359,-219,1360000,0.6,136,115703
"4977",10161,-709,1260000,0.3,126,115829
"376",23445,1054,7e+05,0.825,70,115899
"5233",29709,-931,7e+05,0.3,70,115969
"4028",39687,-232,7e+05,0.6,70,116039
"5930",35934,-1419,1200000,0.1,120,116159
"2698",35536,-459,1200000,0.6,120,116279
"3644",29848,-355,2250000,0.6,225,116504
"1694",31019,323,630000,0.65,63,116567
"991",40056,755,7800000,0.775,780,117347
"1344",43268,181,2200000,0.65,220,117567
"2169",40344,194,1800000,0.65,180,117747
"1611",9070,205,1e+06,0.65,100,117847
"1288",12269,7,7900000,0.65,790,118637
"1574",9547,14,2e+06,0.65,200,118837
"1978",5557,404.25,4080000,0.65,408,119245
"3827",27992,-65,3190000,0.6,319,119564
"1363",33847,323.333333333333,2050000,0.65,205,119769
"652",31147,757,1260000,0.775,126,119895
"59",22270,2191,1e+06,0.9,100,119995
"2975",11191,-384,7e+05,0.6,70,120065
"3400",8737,-154,1e+06,0.6,100,120165
"1512",32799,125.333333333333,5450000,0.65,545,120710
"636",8894,550.666666666667,3460000,0.775,346,121056
"811",28096,906,490000,0.775,49,121105
"1243",13594,435.2,4010000,0.65,401,121506
"1440",10424,63,2270000,0.65,227,121733
"3858",27063,-221,9e+05,0.6,90,121823
"3213",10218,-420,1850000,0.6,185,122008
"90",33245,1639,4140000,0.85,414,122422
"2432",18012,-443,1190000,0.6,119,122541
"4136",23912,-223,640000,0.6,64,122605
"2951",34045,-109,4500000,0.6,450,123055
"210",11880,1088,8e+05,0.825,80,123135
"3241",32729,-486,630000,0.6,63,123198
"964",26085,658,1800000,0.775,180,123378
"1171",36146,128,1e+06,0.65,100,123478
"4081",24207,-112,7e+05,0.6,70,123548
"3322",32259,-324,8e+05,0.6,80,123628
"3766",28835,-209,2450000,0.6,245,123873
"4402",15311,-556,640000,0.3,64,123937
"2503",16802,-314,560000,0.6,56,123993
"2679",14051,-343.666666666667,2620000,0.6,262,124255
"690",42209,576,640000,0.775,64,124319
"293",6677,1051,1750000,0.825,175,124494
"119",7302,1665,1e+06,0.85,100,124594
"1564",9709,4.33333333333333,2990000,0.65,299,124893
"989",40080,755,7240000,0.775,724,125617
"1942",5820,165,1440000,0.65,144,125761
"1392",33686,377,1190000,0.65,119,125880
"2516",36809,-416,8e+05,0.6,80,125960
"2987",11278,-227,2330000,0.6,233,126193
"1762",21190,44,7e+05,0.65,70,126263
"3854",27099,-443,2630000,0.6,263,126526
"831",4989,589,1260000,0.775,126,126652
"1422",33277,225,630000,0.65,63,126715
"1856",29618,114,5910000,0.65,591,127306
"3796",5376,-141,560000,0.6,56,127362
"1866",29099,234,490000,0.65,49,127411
"41",8920,2106,1e+06,0.9,100,127511
"1699",8241,52,2890000,0.65,289,127800
"328",3690,1403,1360000,0.825,136,127936
"3510",30845,-376,8e+05,0.6,80,128016
"4111",270,-329,1990000,0.6,199,128215
"4022",24956,-333,7e+05,0.6,70,128285
"2726",35402,-263,7e+05,0.6,70,128355
"734",28929,517,1e+06,0.775,100,128455
"1946",41894,174.5,1210000,0.65,121,128576
"179",14029,1125,1400000,0.825,140,128716
"907",22823,688,1260000,0.775,126,128842
"107",42618,1647,1360000,0.85,136,128978
"2105",26552,418,1200000,0.65,120,129098
"4298",16806,-853.5,3100000,0.3,310,129408
"2486",17206,-118,1e+06,0.6,100,129508
"4492",14299,-778,1190000,0.3,119,129627
"279",7730,1320.33333333333,3500000,0.825,350,129977
"3969",26041,-51,8e+05,0.6,80,130057
"878",26867,601,1700000,0.775,170,130227
"3696",29181,-483,1120000,0.6,112,130339
"529",33583,831,490000,0.775,49,130388
"3090",10786,-411,1750000,0.6,175,130563
"1473",32979,385,8e+05,0.65,80,130643
"53",41648,2379,1e+06,0.9,100,130743
"4069",24238,-409,560000,0.6,56,130799
"3087",10759,-490,560000,0.6,56,130855
"4325",16416,-771,1700000,0.3,170,131025
"2576",15349,-467,7e+05,0.6,70,131095
"1794",30382,224,4740000,0.65,474,131569
"3656",6811,-2,5800000,0.6,580,132149
"4635",13182,-582,2690000,0.3,269,132418
"154",39796,1559,1990000,0.85,199,132617
"3779",5533,-316,490000,0.6,49,132666
"4554",35555,-780,8e+05,0.3,80,132746
"5367",26928,-662,9e+05,0.3,90,132836
"2839",12608,-498,3760000,0.6,376,133212
"3893",26529,-495,8e+05,0.6,80,133292
"3082",10739,-480,7e+05,0.6,70,133362
"596",32407,800,1260000,0.775,126,133488
"1020",1221,968,7e+05,0.775,70,133558
"2427",17942,-41,7e+05,0.6,70,133628
"272",8606,1274,1700000,0.825,170,133798
"4701",34665,-550,5900000,0.3,590,134388
"3633",6810,-124,7e+05,0.6,70,134458
"1067",38903,647,490000,0.775,49,134507
"1297",34698,348,1340000,0.65,134,134641
"1517",32838,1,1190000,0.65,119,134760
"109",8745,1734,640000,0.85,64,134824
"578",10217,519,1750000,0.775,175,134999
"137",40505,1842,1430000,0.85,143,135142
"3559",30698,-429,1350000,0.6,135,135277
"144",23478,1674,8e+05,0.85,80,135357
"4729",11849,-994,560000,0.3,56,135413
"2025",27643,129,1190000,0.65,119,135532
"3979",40058,-100,560000,0.6,56,135588
"3492",42410,-310,560000,0.6,56,135644
"2841",12206,-478,560000,0.6,56,135700
"325",40728,1144,1e+06,0.825,100,135800
"648",8366,959,1e+06,0.775,100,135900
"1059",39083,741,1680000,0.775,168,136068
"5924",35931,-1269,8e+05,0.1,80,136148
"2526",15987,-369,560000,0.6,56,136204
"7001",24675,-1547,7e+05,0.05,70,136274
"3723",6279,-170,630000,0.6,63,136337
"2668",14185,-138,7e+05,0.6,70,136407
"3961",2038,-144,1e+06,0.6,100,136507
"1644",31903,359,4090000,0.65,409,136916
"3107",33326,-367,560000,0.6,56,136972
"370",25218,1020,720000,0.825,72,137044
"3971",1899,-114.5,1200000,0.6,120,137164
"195",35065,1240.33333333333,4790000,0.825,479,137643
"3266",10071,-289,2500000,0.6,250,137893
"5279",5723,-999.666666666667,3290000,0.3,329,138222
"2014",28267,101,14990000,0.65,1499,139721
"1605",42742,147,1700000,0.65,170,139891
"4536",43685,-634,5600000,0.3,560,140451
"2762",35038,-321.333333333333,5260000,0.6,526,140977
"1345",11663,401,1440000,0.65,144,141121
"2520",36750,-391.666666666667,1820000,0.6,182,141303
"592",10125,670,8e+05,0.775,80,141383
"3691",29157,-277,490000,0.6,49,141432
"860",4291,597,720000,0.775,72,141504
"1985",5518,279,2190000,0.65,219,141723
"3230",10103,-424,490000,0.6,49,141772
"1404",43103,335,7e+05,0.65,70,141842
"6292",30435,-1315,720000,0.1,72,141914
"709",29584,563,2960000,0.775,296,142210
"5909",35990,-1289,8e+05,0.1,80,142290
"480",12950,766,1050000,0.775,105,142395
"2506",36953,-469,8e+05,0.6,80,142475
"2752",13753,-270,560000,0.6,56,142531
"1405",11206,9,2e+06,0.65,200,142731
"2568",15513,-474,3660000,0.6,366,143097
"1131",18161,142,560000,0.65,56,143153
"141",2409,1664.66666666667,2550000,0.85,255,143408
"407",24097,1052,8e+05,0.825,80,143488
"5038",9669,-832,1190000,0.3,119,143607
"796",6079,968,8e+05,0.775,80,143687
"740",6188,653,1360000,0.775,136,143823
"2848",43407,-75,7e+05,0.6,70,143893
"1347",11644,452,8e+05,0.65,80,143973
"2931",34377,-101,8400000,0.6,840,144813
"3620",21169,-253.5,3680000,0.6,368,145181
"1559",9925,67,8e+05,0.65,80,145261
"339",40359,1180,1440000,0.825,144,145405
"889",26598,913,1430000,0.775,143,145548
"1900",42092,392,560000,0.65,56,145604
"342",40337,1129,560000,0.825,56,145660
"3502",30951,-430,5470000,0.6,547,146207
"901",26405,953,1200000,0.775,120,146327
"3447",8738,-421.5,1500000,0.6,150,146477
"2256",25049,415,490000,0.65,49,146526
"5549",38557,-789,640000,0.3,64,146590
"5028",9751,-890,490000,0.3,49,146639
"3538",8206,-199,8e+05,0.6,80,146719
"1463",33088,494,2260000,0.65,226,146945
"2673",43656,-44,8e+05,0.6,80,147025
"721",29368,515,6070000,0.775,607,147632
"490",12246,651,560000,0.775,56,147688
"1323",11668,4,630000,0.65,63,147751
"6632",43942,-1916,560000,0.05,56,147807
"3843",4323,-327,1560000,0.6,156,147963
"4917",33275,-891,8e+05,0.3,80,148043
"2356",24110,335,1e+06,0.65,100,148143
"6108",11425,-1004,630000,0.1,63,148206
"463",35189,720,1e+06,0.775,100,148306
"6301",30478,-1158.5,2890000,0.1,289,148595
"5403",22881,-681,1190000,0.3,119,148714
"33",21389,2113,3840000,0.9,384,149098
"841",27485,796,560000,0.775,56,149154
"3067",10775,-209.5,1500000,0.6,150,149304
"2281",25319,168,2550000,0.65,255,149559
"3480",31198,-53.5,14440000,0.6,1444,151003
"1510",32720,85,7e+05,0.65,70,151073
"4422",36308,-719,560000,0.3,56,151129
"1655",42631,384,2760000,0.65,276,151405
"2381",206,284,630000,0.65,63,151468
"5005",10082,-682,1e+06,0.3,100,151568
"759",29016,614,5600000,0.775,560,152128
"2543",43929,-297,1200000,0.6,120,152248
"3072",33432,-405,3110000,0.6,311,152559
"496",34528,758,1700000,0.775,170,152729
"3655",29624,-1,1350000,0.6,135,152864
"2976",33641,-287,560000,0.6,56,152920
"3835",4825,-461,1e+06,0.6,100,153020
"1445",10506,59,2140000,0.65,214,153234
"1277",34541,360,1200000,0.65,120,153354
"4713",12249,-890.333333333333,1990000,0.3,199,153553
"2856",34366,-270,1e+06,0.6,100,153653
"3314",9500,-3,560000,0.6,56,153709
"6009",13419,-1113,630000,0.1,63,153772
"574",32826,658,1360000,0.775,136,153908
"198",12708,1231,640000,0.825,64,153972
"3389",42715,-31.5,4150000,0.6,415,154387
"2459",37193,-254,8e+05,0.6,80,154467
"5964",14259,-1054,4690000,0.1,469,154936
"4993",10173,-761,1360000,0.3,136,155072
"4431",14921,-781.5,4420000,0.3,442,155514
"1181",14699,380,3760000,0.65,376,155890
"1062",38982,960,7e+05,0.775,70,155960
"1089",405,625,8740000,0.775,874,156834
"456",35640,549,1800000,0.775,180,157014
"2940",11618,-146,1560000,0.6,156,157170
"1936",28758,383,720000,0.65,72,157242
"5292",41588,-974,1850000,0.3,185,157427
"4151",38123,-998,1700000,0.3,170,157597
"2917",43259,-479.8,6680000,0.6,668,158265
"4934",10460,-871,1620000,0.3,162,158427
"2424",37767,-145,1360000,0.6,136,158563
"1322",34100,401,2250000,0.65,225,158788
"349",26105,1134,7e+05,0.825,70,158858
"1614",8976,417,1500000,0.65,150,159008
"4616",13364,-634.5,1190000,0.3,119,159127
"1047",24317,523,2500000,0.775,250,159377
"216",33727,1380,9e+05,0.825,90,159467
"2337",24206,43,490000,0.65,49,159516
"2445",17893,-386,1610000,0.6,161,159677
"1180",36071,309,9e+05,0.65,90,159767
"4898",10533,-651,1050000,0.3,105,159872
"3506",30870,-332,8e+05,0.6,80,159952
"2914",34042,-93.5,1900000,0.6,190,160142
"3227",32901,-424,3530000,0.6,353,160495
"2605",36144,-420,1050000,0.6,105,160600
"1571",9734,311,7e+05,0.65,70,160670
"2278",989,171,560000,0.65,56,160726
"4055",39266,-493,720000,0.6,72,160798
"6562",17971,-1577,490000,0.05,49,160847
"554",10427,830,2700000,0.775,270,161117
"3850",27349,-247,4740000,0.6,474,161591
"1570",9488,489.25,4980000,0.65,498,162089
"3068",33393,-441,2190000,0.6,219,162308
"1503",10160,65,7e+05,0.65,70,162378
"3626",6949,-51,490000,0.6,49,162427
"4912",10712,-659,1260000,0.3,126,162553
"485",34738,916,2420000,0.775,242,162795
"2829",12440,-280.333333333333,1990000,0.6,199,162994
"1683",31459,273,2550000,0.65,255,163249
"3991",39984,-496,7e+05,0.6,70,163319
"2554",43857,-150,1190000,0.6,119,163438
"2734",13487,-374,1490000,0.6,149,163587
"5515",38849,-522,560000,0.3,56,163643
"1657",31428,162.666666666667,1960000,0.65,196,163839
"2458",37272,-470,2500000,0.6,250,164089
"404",24133,1413,8e+05,0.825,80,164169
"2665",14353,-59,3e+06,0.6,300,164469
"5332",4902,-549,1290000,0.3,129,164598
"3407",23726,-451,2260000,0.6,226,164824
"3139",10359,-380,8e+05,0.6,80,164904
"1014",39749,751,7e+05,0.775,70,164974
"5305",5317,-835,490000,0.3,49,165023
"888",26774,559,1400000,0.775,140,165163
"629",8837,804,490000,0.775,49,165212
"666",7925,993,560000,0.775,56,165268
"2231",25950,462,2680000,0.65,268,165536
"3848",40895,-407,490000,0.6,49,165585
"4397",15509,-972,640000,0.3,64,165649
"2451",37278,-458,8e+05,0.6,80,165729
"1274",34709,161,2260000,0.65,226,165955
"217",11489,1300,8e+05,0.825,80,166035
"3245",32736,-181,3140000,0.6,314,166349
"4683",12183,-791,630000,0.3,63,166412
"2938",33959,-207,1700000,0.6,170,166582
"5079",31818,-558,2500000,0.3,250,166832
"1646",8875,93.5,2e+06,0.65,200,167032
"1354",43181,326,1e+06,0.65,100,167132
"1333",21554,452,1920000,0.65,192,167324
"3297",32693,-405,3010000,0.6,301,167625
"6259",23722,-1348,1490000,0.1,149,167774
"2010",41207,416,2140000,0.65,214,167988
"4833",33495,-805.5,3430000,0.3,343,168331
"3845",4538,-443,8e+05,0.6,80,168411
"1335",34166,118,3450000,0.65,345,168756
"6559",18146,-1577,8e+05,0.05,80,168836
"1035",39486,528,560000,0.775,56,168892
"1386",11379,270.5,2060000,0.65,206,169098
"340",40407,1374.66666666667,5950000,0.825,595,169693
"3187",32916,-348,560000,0.6,56,169749
"126",29109,1658,1360000,0.85,136,169885
"3678",6511,-149,630000,0.6,63,169948
"2202",26096,378,2440000,0.65,244,170192
"769",41784,794,490000,0.775,49,170241
"2685",14037,-496,8e+05,0.6,80,170321
"754",28888,910,1190000,0.775,119,170440
"1251",43564,440,4490000,0.65,449,170889
"1649",42623,190.5,3190000,0.65,319,171208
"5193",30457,-587,6490000,0.3,649,171857
"1459",10483,157,9e+05,0.65,90,171947
"2052",26995,354,8e+05,0.65,80,172027
"1822",6615,373,560000,0.65,56,172083
"913",2837,829,1e+06,0.775,100,172183
"2065",3901,107,7e+05,0.65,70,172253
"2163",40461,454,4040000,0.65,404,172657
"375",25442,1102,4980000,0.825,498,173155
"3350",32049,-412,7e+05,0.6,70,173225
"434",14867,722,3420000,0.775,342,173567
"2245",1465,122,1350000,0.65,135,173702
"3617",7188,-124,1700000,0.6,170,173872
"1952",6087,220,3190000,0.65,319,174191
"222",33468,1075,4560000,0.825,456,174647
"4614",43538,-813,490000,0.3,49,174696
"3380",42678,-393,4690000,0.6,469,175165
"1336",21532,41,560000,0.65,56,175221
"936",26197,691,2400000,0.775,240,175461
"6491",24957,-1018,490000,0.1,49,175510
"3870",26936,-472,4460000,0.6,446,175956
"175",14153,1280,3060000,0.825,306,176262
"424",36753,814,560000,0.775,56,176318
"3180",33017,-477,1190000,0.6,119,176437
"1713",30918,373,560000,0.65,56,176493
"3075",10966,-201,2e+06,0.6,200,176693
"693",29387,575,1800000,0.775,180,176873
"691",21160,732,560000,0.775,56,176929
"3259",32784,-58,3450000,0.6,345,177274
"1527",32888,1,2550000,0.65,255,177529
"277",8607,1027,1440000,0.825,144,177673
"903",40595,795,640000,0.775,64,177737
"865",27062,807,1260000,0.775,126,177863
"2339",38942,178,7e+05,0.65,70,177933
"2535",15965,-141,1890000,0.6,189,178122
"1457",10425,8,720000,0.65,72,178194
"1040",751,974,1560000,0.775,156,178350
"6472",25381,-1458,1530000,0.1,153,178503
"3872",26776,-325,1e+06,0.6,100,178603
"1989",28127,487.5,2260000,0.65,226,178829
"5501",39432,-684,720000,0.3,72,178901
"1313",34122,313,8e+05,0.65,80,178981
"2288",24432,244,630000,0.65,63,179044
"2018",4854,457,490000,0.65,49,179093
"736",42065,551,7e+05,0.775,70,179163
"1723",31118,263,2890000,0.65,289,179452
"2433",18104,-438,2260000,0.6,226,179678
"435",14945,787,1360000,0.775,136,179814
"410",24177,1208.5,2090000,0.825,209,180023
"2583",15621,-87,4060000,0.6,406,180429
"2324",554,330,630000,0.65,63,180492
"2214",1740,289,490000,0.65,49,180541
"4016",25139,-251,8e+05,0.6,80,180621
"247",32613,1284,3240000,0.825,324,180945
"5171",7838,-728,630000,0.3,63,181008
"1761",42271,219,1500000,0.65,150,181158
"1994",28223,75,1690000,0.65,169,181327
"2733",13819,-163,1360000,0.6,136,181463
"2872",11966,-477,490000,0.6,49,181512
"1034",866,653,1460000,0.775,146,181658
"819",5298,525.5,3470000,0.775,347,182005
"3006",33799,-63,2960000,0.6,296,182301
"4198",37560,-570,560000,0.3,56,182357
"2948",33838,-143,7e+05,0.6,70,182427
"1413",43146,323,7e+05,0.65,70,182497
"1934",21058,461,1440000,0.65,144,182641
"1538",32714,14,1500000,0.65,150,182791
"973",44201,649,1800000,0.775,180,182971
"2296",770,393,9e+05,0.65,90,183061
"2241",25409,151,720000,0.65,72,183133
"124",6736,1503,8e+05,0.85,80,183213
"79",34760,1760,1200000,0.85,120,183333
"1714",8035,373,640000,0.65,64,183397
"1066",24255,788,6700000,0.775,670,184067
"1341",11711,26,1360000,0.65,136,184203
"3405",8678,-153,3900000,0.6,390,184593
"1408",33592,368,3300000,0.65,330,184923
"4411",23851,-972,560000,0.3,56,184979
"6324",6313,-1197,1890000,0.1,189,185168
"3929",40503,-233,2260000,0.6,226,185394
"421",36965,620,2140000,0.775,214,185608
"906",2888,651,7e+05,0.775,70,185678
"3186",32993,-168.333333333333,5940000,0.6,594,186272
"2805",34904,-32,8120000,0.6,812,187084
"3824",41174,-432.5,2060000,0.6,206,187290
"2701",35563,-51,1560000,0.6,156,187446
"2159",40422,168,9e+05,0.65,90,187536
"5150",31080,-902,1620000,0.3,162,187698
"4243",17547,-690,2750000,0.3,275,187973
"1534",42894,206,3990000,0.65,399,188372
"4042",39491,-205.5,2080000,0.6,208,188580
"1002",25265,655.666666666667,2630000,0.775,263,188843
"2505",37026,-372,2750000,0.6,275,189118
"2392",38205,-470,1260000,0.6,126,189244
"4285",36957,-553,8e+05,0.3,80,189324
"3291",9808,-332,1800000,0.6,180,189504
"3585",7446,-497,1360000,0.6,136,189640
"384",39849,1238,7800000,0.825,780,190420
"3722",6071,-255,490000,0.6,49,190469
"4494",14140,-544,1960000,0.3,196,190665
"1471",10252,483.5,1440000,0.65,144,190809
"3207",10170,-414,560000,0.6,56,190865
"1927",41926,32.5,1700000,0.65,170,191035
"3764",5899,-311,1e+06,0.6,100,191135
"21",36142,2426,560000,0.9,56,191191
"647",31188,959,7e+05,0.775,70,191261
"4925",33140,-639.666666666667,5530000,0.3,553,191814
"573",33012,599,4780000,0.775,478,192292
"2051",40858,354,1260000,0.65,126,192418
"3054",10850,-85,1750000,0.6,175,192593
"2125",26400,238,640000,0.65,64,192657
"1174",14849,22,560000,0.65,56,192713
"260",42734,1258,1990000,0.825,199,192912
"756",6024,584,8e+05,0.775,80,192992
"5426",26016,-511,3110000,0.3,311,193303
"3239",32839,-434,1750000,0.6,175,193478
"5637",37471,-1124,720000,0.1,72,193550
"3029",11144,-482,2770000,0.6,277,193827
"658",8403,604,560000,0.775,56,193883
"2493",17277,-307,1360000,0.6,136,194019
"1416",21431,9,1e+06,0.65,100,194119
"20",36182,2426,490000,0.9,49,194168
"5115",31383,-579,490000,0.3,49,194217
"768",41995,801,2490000,0.775,249,194466
"505",34219,692,8e+05,0.775,80,194546
"720",6289,509,560000,0.775,56,194602
"1033",39621,528,1050000,0.775,105,194707
"3911",2723,-338,8e+05,0.6,80,194787
"2405",18530,-113,7e+05,0.6,70,194857
"1931",42037,39,1260000,0.65,126,194983
"3456",31174,-217,490000,0.6,49,195032
"2534",15778,-441,1600000,0.6,160,195192
"645",42575,705,1800000,0.775,180,195372
"4629",13061,-553,1490000,0.3,149,195521
"1722",30916,61,9e+05,0.65,90,195611
"4195",18017,-804,1260000,0.3,126,195737
"802",28252,717,1e+06,0.775,100,195837
"1281",34488,351,1430000,0.65,143,195980
"1140",17204,19,2700000,0.65,270,196250
"3081",10770,-244.5,2400000,0.6,240,196490
"1791",30459,461,6020000,0.65,602,197092
"2209",26040,277,1260000,0.65,126,197218
"1291",12219,455.5,2600000,0.65,260,197478
"4074",39013,-300,2400000,0.6,240,197718
"3927",26308,-338,1920000,0.6,192,197910
"534",33620,919,1360000,0.775,136,198046
"3117",10553,-475,490000,0.6,49,198095
"1286",12261,475,1050000,0.65,105,198200
"1078",398,858,7e+05,0.775,70,198270
"3522",7850,-442,720000,0.6,72,198342
"943",26117,526,7e+05,0.775,70,198412
"4307",17011,-573,1700000,0.3,170,198582
"360",25593,1070,8e+05,0.825,80,198662
"1428",10597,262,1120000,0.65,112,198774
"2584",23840,-410,1290000,0.6,129,198903
"3010",11125,-101,7e+05,0.6,70,198973
"4221",17700,-856.428571428571,6400000,0.3,640,199613
"869",27124,929,1900000,0.775,190,199803
"3312",9588,-116,490000,0.6,49,199852
"116",30170,1665,7e+05,0.85,70,199922
"2147",26301,112,560000,0.65,56,199978
"2360",407,243,7e+05,0.65,70,200048
"2553",43834,-460,810000,0.6,81,200129
"1044",893,810,7e+05,0.775,70,200199
"2887",34207,-255,8e+05,0.6,80,200279
"2949",34063,-362.5,5410000,0.6,541,200820
"3096",43056,-347,2190000,0.6,219,201039
"4462",43720,-830,640000,0.3,64,201103
"9",31235,2838,1190000,0.925,119,201222
"3632",29556,-124,490000,0.6,49,201271
"3005",11263,-395,1190000,0.6,119,201390
"967",40102,666,8e+05,0.775,80,201470
"3605",7314,-220.333333333333,3300000,0.6,330,201800
"3782",5549,-321,1850000,0.6,185,201985
"1951",28570,181,1050000,0.65,105,202090
"4214",17733,-717,640000,0.3,64,202154
"3089",33257,-198,7e+05,0.6,70,202224
"3299",9703,-180.5,1950000,0.6,195,202419
"1491",32849,472.666666666667,4310000,0.65,431,202850
"2707",13710,-65.5,2e+06,0.6,200,203050
"5239",42132,-920,1360000,0.3,136,203186
"601",9497,951,1e+06,0.775,100,203286
"2036",40908,292,490000,0.65,49,203335
"2913",34006,-385.5,1520000,0.6,152,203487
"3887",3586,-488,1190000,0.6,119,203606
"805",28233,680,560000,0.775,56,203662
"209",34331,1479,2560000,0.825,256,203918
"72",35633,1817,2060000,0.85,206,204124
"1582",9536,92,630000,0.65,63,204187
"149",24454,1559,560000,0.85,56,204243
"3224",33079,-95,2550000,0.6,255,204498
"610",23058,597,1190000,0.775,119,204617
"626",9140,675,2680000,0.775,268,204885
"723",6283,564,2260000,0.775,226,205111
"2580",43845,-151,3960000,0.6,396,205507
"4978",32884,-789,1260000,0.3,126,205633
"1837",29587,116,1260000,0.65,126,205759
"4271",36995,-713,1e+06,0.3,100,205859
"2015",27588,391,560000,0.65,56,205915
"3828",5120,-384,1e+06,0.6,100,206015
"1815",29440,294,640000,0.65,64,206079
"4427",36295,-937,1290000,0.3,129,206208
"3533",8030,-495.666666666667,3520000,0.6,352,206560
"2958",33949,-286,1990000,0.6,199,206759
"3133",44315,-369.5,1340000,0.6,134,206893
"2232",25840,97,1190000,0.65,119,207012
"1825",30198,158,4990000,0.65,499,207511
"226",33155,1176,1800000,0.825,180,207691
"1718",30998,329,3130000,0.65,313,208004
"1358",34114,120,1190000,0.65,119,208123
"2781",12934,-491.5,2240000,0.6,224,208347
"3859",26953,-243,8e+05,0.6,80,208427
"1771",7208,241,1190000,0.65,119,208546
"6061",34274,-1387,1050000,0.1,105,208651
"1686",8208,493,640000,0.65,64,208715
"4017",25137,-251,640000,0.6,64,208779
"3810",27972,-65,560000,0.6,56,208835
"2319",39263,176,3750000,0.65,375,209210
"2867",34321,-34,2500000,0.6,250,209460
"1737",8351,27,8e+05,0.65,80,209540
"1664",31562,42,4550000,0.65,455,209995
"187",13610,1257,7e+05,0.825,70,210065
"177",35894,1089,1120000,0.825,112,210177
"2800",12892,-385,560000,0.6,56,210233
"3284",10004,-454.75,4290000,0.6,429,210662
"1799",6913,469,7e+05,0.65,70,210732
"1717",8011,15,8e+05,0.65,80,210812
"533",33619,793,4030000,0.775,403,211215
"6244",31915,-1203.5,1400000,0.1,140,211355
"306",41732,1048,2240000,0.825,224,211579
"273",31283,1062,3350000,0.825,335,211914
"650",42526,663,7e+05,0.775,70,211984
"5205",30056,-845,490000,0.3,49,212033
"2669",35772,-305.5,1290000,0.6,129,212162
"400",38908,1059,1e+06,0.825,100,212262
"1361",21519,41,1190000,0.65,119,212381
"4472",36092,-812.5,1850000,0.3,185,212566
"3482",8106,-458.75,2660000,0.6,266,212832
"5440",26009,-821,9390000,0.3,939,213771
"2287",24492,212.5,1280000,0.65,128,213899
"4787",33818,-874,560000,0.3,56,213955
"4778",33936,-932,1260000,0.3,126,214081
"2028",4645,292,7e+05,0.65,70,214151
"4510",23805,-649,3250000,0.3,325,214476
"1351",11502,230.5,1490000,0.65,149,214625
"509",11558,566,8e+05,0.775,80,214705
"3816",20903,-316,640000,0.6,64,214769
"3831",27949,-15,2410000,0.6,241,215010
"4936",10365,-730.5,1920000,0.3,192,215202
"4160",38102,-808,2e+06,0.3,200,215402
"4466",14404,-649,1200000,0.3,120,215522
"3631",7137,-124,560000,0.6,56,215578
"1091",38656,559,1400000,0.775,140,215718
"3201",10179,-18,1190000,0.6,119,215837
"3212",10202,-420,1700000,0.6,170,216007
"5560",10,-894,1190000,0.3,119,216126
"1122",18038,167,1050000,0.65,105,216231
"2215",1771,289,7e+05,0.65,70,216301
"2827",12529,-348,7590000,0.6,759,217060
"3737",28872,-328,7e+05,0.6,70,217130
"1075",38804,647,1260000,0.775,126,217256
"2816",12634,-353,720000,0.6,72,217328
"3325",9459,-3,7e+05,0.6,70,217398
"3871",3867,-327,1700000,0.6,170,217568
"2312",24304,236,2940000,0.65,294,217862
"818",28421,523,3270000,0.775,327,218189
"2462",37187,-318,1190000,0.6,119,218308
"1673",8467,50.6666666666667,3680000,0.65,368,218676
"4091",380,-469,7e+05,0.6,70,218746
"2853",34428,-243,1700000,0.6,170,218916
"2076",26915,104,1190000,0.65,119,219035
"3569",30429,-98,7e+05,0.6,70,219105
"538",10912,594,560000,0.775,56,219161
"4316",16625,-699,1e+06,0.3,100,219261
"123",29778,1647,7e+05,0.85,70,219331
"3955",26165,-75,7e+05,0.6,70,219401
"4122",23946,-166,1920000,0.6,192,219593
"1337",21539,131,640000,0.65,64,219657
"499",34201,822,9e+05,0.775,90,219747
"1225",35632,132,9e+05,0.65,90,219837
"234",33184,1443,4180000,0.825,418,220255
"3179",10317,-171,1360000,0.6,136,220391
"3980",18994,-255,7e+05,0.6,70,220461
"6692",36221,-1666,1050000,0.05,105,220566
"6047",12162,-1116,7e+05,0.1,70,220636
"5272",28800,-705,8e+05,0.3,80,220716
"951",40175,803,2750000,0.775,275,220991
"2485",17235,-118,7e+05,0.6,70,221061
"3741",41923,-463,1700000,0.6,170,221231
"4749",11984,-769,1700000,0.3,170,221401
"2061",20364,435,1e+06,0.65,100,221501
"3071",33296,-30,1500000,0.6,150,221651
"4026",25015,-479,3060000,0.6,306,221957
"2099",3238,38,8e+05,0.65,80,222037
"649",31182,959,8e+05,0.775,80,222117
"4531",35654,-552,1700000,0.3,170,222287
"4669",43434,-584,9e+05,0.3,90,222377
"1296",34277,83,8e+05,0.65,80,222457
"2442",17944,-230,3050000,0.6,305,222762
"544",33259,670,1800000,0.775,180,222942
"6511",657,-1292,1680000,0.1,168,223110
"3788",28241,-141,7e+05,0.6,70,223180
"23",13986,2135,720000,0.9,72,223252
"2185",26151,394,490000,0.65,49,223301
"2811",12721,-107,1120000,0.6,112,223413
"942",40199,888,1990000,0.775,199,223612
"394",39386,1093,6320000,0.825,632,224244
"3253",42898,-26,1e+06,0.6,100,224344
"1484",32970,467,7e+05,0.65,70,224414
"2870",11949,-11,490000,0.6,49,224463
"1167",14920,127,2400000,0.65,240,224703
"1100",167,540,560000,0.775,56,224759
"1196",35816,42.5,1500000,0.65,150,224909
"671",30123,766.5,1400000,0.775,140,225049
"4224",17808,-920.5,2630000,0.3,263,225312
"4087",462,-112,8e+05,0.6,80,225392
"5234",29860,-542,4350000,0.3,435,225827
"3272",10020,-277,7e+05,0.6,70,225897
"1740",30707,107,1440000,0.65,144,226041
"1325",11919,16,9e+05,0.65,90,226131
"2394",18616,-380,560000,0.6,56,226187
"46",8025,2224,1340000,0.9,134,226321
"3670",29292,-210,7e+05,0.6,70,226391
"2540",43859,-150,7e+05,0.6,70,226461
"2561",36460,-380,1700000,0.6,170,226631
"5452",1449,-565,7e+05,0.3,70,226701
"2439",17780,-121,7e+05,0.6,70,226771
"867",4390,596,640000,0.775,64,226835
"1223",14034,269,7e+05,0.65,70,226905
"2092",26725,308,490000,0.65,49,226954
"3472",42423,-47,8e+05,0.6,80,227034
"6093",11651,-1372,1260000,0.1,126,227160
"977",25914,648.5,1260000,0.775,126,227286
"3964",40152,-144,560000,0.6,56,227342
"1830",29413,261.5,1290000,0.65,129,227471
"1009",25094,603,7e+05,0.775,70,227541
"3242",42882,-232,560000,0.6,56,227597
"3309",9504,-400,1490000,0.6,149,227746
"3459",21265,-372.5,1120000,0.6,112,227858
"3121",33350,-175,7700000,0.6,770,228628
"5011",32705,-724,8e+05,0.3,80,228708
"5509",38971,-539,3550000,0.3,355,229063
"4650",23758,-676,2360000,0.3,236,229299
"431",44386,550,1260000,0.775,126,229425
"389",24662,1238,8080000,0.825,808,230233
"5651",17750,-1048,1990000,0.1,199,230432
"5827",36458,-1261,2090000,0.1,209,230641
"3424",8663,-170,1e+06,0.6,100,230741
"3078",10716,-422,1190000,0.6,119,230860
"3188",42932,-374.5,5410000,0.6,541,231401
"2923",34040,-216.5,1200000,0.6,120,231521
"3419",8684,-339.5,1920000,0.6,192,231713
"1427",33220,28,1260000,0.65,126,231839
"61",23609,2476,7e+05,0.9,70,231909
"460",13752,650,1360000,0.775,136,232045
"4380",15446,-956,630000,0.3,63,232108
"5554",51,-697,1800000,0.3,180,232288
"1727",7988,122,9e+05,0.65,90,232378
"2622",14554,-199,8e+05,0.6,80,232458
"4858",11250,-832,3600000,0.3,360,232818
"694",29604,729,2e+06,0.775,200,233018
"988",25954,647,1360000,0.775,136,233154
"204",12323,1195,1760000,0.825,176,233330
"3514",8084,-379,720000,0.6,72,233402
"4124",249,-166,1800000,0.6,180,233582
"3476",8325,-71,630000,0.6,63,233645
"3220",10126,-395,8e+05,0.6,80,233725
"583",23068,715,4750000,0.775,475,234200
"3471",31032,-424,640000,0.6,64,234264
"406",38837,1187,560000,0.825,56,234320
"3493",42435,-133,3530000,0.6,353,234673
"2549",36540,-24,1990000,0.6,199,234872
"5717",17039,-1267,8e+05,0.1,80,234952
"976",26063,572,1050000,0.775,105,235057
"2362",38753,316,8e+05,0.65,80,235137
"883",3741,722,1700000,0.775,170,235307
"1072",38814,681,1800000,0.775,180,235487
"2176",40244,218,560000,0.65,56,235543
"2674",14114,-415,2630000,0.6,263,235806
"2599",36167,-393,1400000,0.6,140,235946
"2646",44337,-481,1620000,0.6,162,236108
"1116",18223,3.5,1500000,0.65,150,236258
"1041",39204,856,1600000,0.775,160,236418
"1138",36942,489,8e+05,0.65,80,236498
"1588",42793,367.5,1050000,0.65,105,236603
"5143",8298,-960,1350000,0.3,135,236738
"2598",14813,-271,1700000,0.6,170,236908
"3948",40277,-180,560000,0.6,56,236964
"6370",28000,-1300,720000,0.1,72,237036
"2157",22680,242,2090000,0.65,209,237245
"4576",43632,-535,1190000,0.3,119,237364
"3349",9035,-264,560000,0.6,56,237420
"4643",13108,-617,2400000,0.3,240,237660
"4985",10163,-760.5,2400000,0.3,240,237900
"2563",36367,-467,560000,0.6,56,237956
"5358",4236,-744.5,1260000,0.3,126,238082
"252",32546,1115,1190000,0.825,119,238201
"5260",5980,-781,1050000,0.3,105,238306
"4567",13703,-784.5,1500000,0.3,150,238456
"3485",30977,-367.5,1280000,0.6,128,238584
"296",29150,1275,1e+06,0.825,100,238684
"468",35322,968,3200000,0.775,320,239004
"1349",33952,26,7e+05,0.65,70,239074
"882",40695,722,490000,0.775,49,239123
"3551",30362,-241,640000,0.6,64,239187
"57",2082,2381,560000,0.9,56,239243
"4286",36990,-946,8e+05,0.3,80,239323
"3895",3231,-215,720000,0.6,72,239395
"1996",41782,231,1440000,0.65,144,239539
"1269",34690,33,1540000,0.65,154,239693
"2810",43495,-320,1360000,0.6,136,239829
"1793",7415,387,560000,0.65,56,239885
"5499",39629,-655,640000,0.3,64,239949
"2233",25721,82,1e+06,0.65,100,240049
"2945",34004,-290.5,5620000,0.6,562,240611
"2031",41321,491.5,2160000,0.65,216,240827
"1526",32800,423,3620000,0.65,362,241189
"1367",33974,59,1750000,0.65,175,241364
"6278",8303,-1092,1360000,0.1,136,241500
"1304",43330,448,1050000,0.65,105,241605
"3043",43105,-484,8e+05,0.6,80,241685
"2219",40009,314.5,1560000,0.65,156,241841
"470",35127,813.5,3380000,0.775,338,242179
"4125",38609,-92.5,1520000,0.6,152,242331
"3466",8235,-427.5,3790000,0.6,379,242710
"5045",9214,-643,9e+05,0.3,90,242800
"472",43529,544,1260000,0.775,126,242926
"4822",33678,-732,2900000,0.3,290,243216
"5003",10009,-721,560000,0.3,56,243272
"3335",42790,-125,1120000,0.6,112,243384
"3943",2676,-316,9e+05,0.6,90,243474
"3820",41237,-360,5440000,0.6,544,244018
"2032",41016,153.5,2830000,0.65,283,244301
"2078",3639,104,490000,0.65,49,244350
"5212",29579,-650,1e+06,0.3,100,244450
"4033",995,-48,7e+05,0.6,70,244520
"2642",43690,-162,9e+05,0.6,90,244610
"93",42855,1906,490000,0.85,49,244659
"12",22283,2703,7e+05,0.925,70,244729
"3855",40879,-42,3940000,0.6,394,245123
"6601",17452,-1782,490000,0.05,49,245172
"5516",38887,-522,7e+05,0.3,70,245242
"3026",43128,-16,2550000,0.6,255,245497
"1102",143,744,490000,0.775,49,245546
"921",19400,791,640000,0.775,64,245610
"4268",37063,-959,7e+05,0.3,70,245680
"3252",32703,-415,5110000,0.6,511,246191
"5342",27563,-613,7e+05,0.3,70,246261
"390",24302,1209,1200000,0.825,120,246381
"5845",44376,-1198,1260000,0.1,126,246507
"2090",3402,412,560000,0.65,56,246563
"1446",10504,147,1800000,0.65,180,246743
"1956",28591,97,1e+06,0.65,100,246843
"1384",11578,303,3240000,0.65,324,247167
"1631",31968,264,5190000,0.65,519,247686
"1024",25048,968,490000,0.775,49,247735
"3936",26208,-221,8e+05,0.6,80,247815
"238",42895,1277,4110000,0.825,411,248226
"3844",27350,-443,1190000,0.6,119,248345
"5208",30390,-515,3350000,0.3,335,248680
"345",2523,1331,7e+05,0.825,70,248750
"5024",32419,-557,8e+05,0.3,80,248830
"444",14269,659.5,1360000,0.775,136,248966
"2967",33755,-351,1190000,0.6,119,249085
"4196",37693,-717,1190000,0.3,119,249204
"3868",4171,-304,2690000,0.6,269,249473
"2479",37084,-263.666666666667,2850000,0.6,285,249758
"2355",481,489.5,2800000,0.65,280,250038
"3647",30229,-87,6070000,0.6,607,250645
"4365",16002,-719,1260000,0.3,126,250771
"1209",14073,312,7e+05,0.65,70,250841
"692",29544,870,8e+05,0.775,80,250921
"1458",33089,8,2730000,0.65,273,251194
"3921",19638,-417,8e+05,0.6,80,251274
"5221",29495,-788,640000,0.3,64,251338
"4830",21480,-753,8e+05,0.3,80,251418
"3441",42752,-393,12240000,0.6,1224,252642
"5125",31371,-897,8e+05,0.3,80,252722
"2640",43713,-413,720000,0.6,72,252794
"512",11778,692,2060000,0.775,206,253000
"6115",43150,-1489,1750000,0.1,175,253175
"4702",34639,-603,1050000,0.3,105,253280
"5278",28455,-532,560000,0.3,56,253336
"2761",35054,-276,1190000,0.6,119,253455
"2533",36630,-166,1e+06,0.6,100,253555
"1888",29052,220,7e+05,0.65,70,253625
"3747",42021,-239,640000,0.6,64,253689
"1099",38592,749,720000,0.775,72,253761
"603",9641,573,1490000,0.775,149,253910
"2013",28156,229,7250000,0.65,725,254635
"1705",31016,79,8e+05,0.65,80,254715
"3601",7288,-497,560000,0.6,56,254771
"1270",34735,120,720000,0.65,72,254843
"2005",20949,146.333333333333,6730000,0.65,673,255516
"4114",23971,-158,1050000,0.6,105,255621
"1095",38654,573,640000,0.775,64,255685
"2156",40446,324,1350000,0.65,135,255820
"506",34032,692,640000,0.775,64,255884
"656",31791,782,7150000,0.775,715,256599
"383",1072,1295,490000,0.825,49,256648
"4068",39027,-26,1890000,0.6,189,256837
"4155",18630,-614,1360000,0.3,136,256973
"96",42872,1906,1500000,0.85,150,257123
"803",41506,638,1640000,0.775,164,257287
"1146",36623,225,8e+05,0.65,80,257367
"474",35194,601,1890000,0.775,189,257556
"2038",27286,220,1190000,0.65,119,257675
"70",43684,1751,1190000,0.85,119,257794
"711",29194,825,7e+05,0.775,70,257864
"327",3365,1403,7e+05,0.825,70,257934
"2472",17369,-318,490000,0.6,49,257983
"3674",6601,-227,1190000,0.6,119,258102
"4415",36539,-701.2,7770000,0.3,777,258879
"3882",3484,-488,560000,0.6,56,258935
"3685",6420,-231,7e+05,0.6,70,259005
"3645",30179,-323,4150000,0.6,415,259420
"1433",10556,255,2050000,0.65,205,259625
"1419",33219,81,1190000,0.65,119,259744
"1632",31870,293,4450000,0.65,445,260189
"457",13876,574,1260000,0.775,126,260315
"6500",39215,-1364,1360000,0.1,136,260451
"1045",24375,883,3680000,0.775,368,260819
"2220",40032,477,1700000,0.65,170,260989
"6283",42392,-1461,1190000,0.1,119,261108
"2718",35502,-319,2060000,0.6,206,261314
"1769",7147,177.5,1120000,0.65,112,261426
"2682",13983,-44,1190000,0.6,119,261545
"2308",39105,260,8e+05,0.65,80,261625
"807",41682,801,2360000,0.775,236,261861
"3286",32634,-244,3090000,0.6,309,262170
"3421",31473,-371,2190000,0.6,219,262389
"924",40437,840,8e+05,0.775,80,262469
"3498",30965,-446,560000,0.6,56,262525
"3445",8402,-351,560000,0.6,56,262581
"1107",18636,74,7e+05,0.65,70,262651
"230",42940,1085,640000,0.825,64,262715
"3332",32222,-239,4460000,0.6,446,263161
"1637",31645,27,1400000,0.65,140,263301
"1862",29324,479,1190000,0.65,119,263420
"2860",43347,-381,4220000,0.6,422,263842
"780",28532,658,1e+06,0.775,100,263942
"381",1127,1054,490000,0.825,49,263991
"1909",6022,37,630000,0.65,63,264054
"3968",1914,-414,1e+06,0.6,100,264154
"5534",223,-936,8e+05,0.3,80,264234
"2413",18120,-394,2180000,0.6,218,264452
"1579",32205,182.5,1750000,0.65,175,264627
"3860",27001,-243,7e+05,0.6,70,264697
"182",13926,1122,490000,0.825,49,264746
"4654",35119,-836.5,2650000,0.3,265,265011
"3849",27401,-83,1360000,0.6,136,265147
"100",42848,1875,490000,0.85,49,265196
"3499",31137,-317,4420000,0.6,442,265638
"1551",9838,9,1260000,0.65,126,265764
"508",34021,566,3940000,0.775,394,266158
"1309",34133,2.66666666666667,3610000,0.65,361,266519
"944",40189,504,8e+05,0.775,80,266599
"5624",17913,-1173,1130000,0.1,113,266712
"4832",10997,-755.5,2920000,0.3,292,267004
"473",13604,534,1680000,0.775,168,267172
"4040",24598,-328,1690000,0.6,169,267341
"172",35947,1280,7e+05,0.825,70,267411
"3873",26800,-462,1700000,0.6,170,267581
"5035",32254,-858,7e+05,0.3,70,267651
"1046",24315,819,2140000,0.775,214,267865
"4585",13398,-532.5,1560000,0.3,156,268021
"6528",38570,-1218,1440000,0.1,144,268165
"43",8742,2490,1600000,0.9,160,268325
"1051",24248,552,490000,0.775,49,268374
"2193",1987,423.333333333333,2290000,0.65,229,268603
"3328",9376,-227,1360000,0.6,136,268739
"2636",36061,-306,1990000,0.6,199,268938
"1501",32795,412,2190000,0.65,219,269157
"6533",18769,-1501,560000,0.05,56,269213
"2592",14912,-197,1050000,0.6,105,269318
"6079",11787,-1011,9e+05,0.1,90,269408
"2211",40050,180,560000,0.65,56,269464
"1940",5976,331.666666666667,1850000,0.65,185,269649
"996",1605,513,1e+06,0.775,100,269749
"4671",12818,-550,5400000,0.3,540,270289
"3724",28976,-277,1190000,0.6,119,270408
"521",21503,702.5,1260000,0.775,126,270534
"5863",36285,-1039,3200000,0.1,320,270854
"4687",12589,-534,1990000,0.3,199,271053
"4681",34633,-521,1990000,0.3,199,271252
"3388",31622,-122,7e+05,0.6,70,271322
"2374",354,319,8e+05,0.65,80,271402
"2814",34631,-280.333333333333,4160000,0.6,416,271818
"1435",10517,320,7e+05,0.65,70,271888
"1137",36939,489,640000,0.65,64,271952
"4032",24952,-480,2190000,0.6,219,272171
"197",34741,1113,1540000,0.825,154,272325
"1013",39746,714,560000,0.775,56,272381
"447",35848,645.333333333333,3790000,0.775,379,272760
"47",30272,2157,560000,0.9,56,272816
"2094",26646,12,490000,0.65,49,272865
"8",10096,2992,560000,0.925,56,272921
"3159",33107,-200,1360000,0.6,136,273057
"2333",39086,152,4230000,0.65,423,273480
"6005",13463,-1033,8e+05,0.1,80,273560
"173",35884,1077,7e+05,0.825,70,273630
"312",28086,1491,9e+05,0.825,90,273720
"4420",36315,-736,490000,0.3,49,273769
"2004",28122,306,3520000,0.65,352,274121
"3603",29928,-177,1430000,0.6,143,274264
"2226",39977,477,7e+05,0.65,70,274334
"5237",6392,-595,560000,0.3,56,274390
"2045",40892,378.5,2140000,0.65,214,274604
"430",36486,532,8e+05,0.775,80,274684
"696",29421,582,640000,0.775,64,274748
"1849",42160,400,7e+05,0.65,70,274818
"2589",36324,-454,1190000,0.6,119,274937
"3436",31294,-351,1490000,0.6,149,275086
"4779",33919,-846,5960000,0.3,596,275682
"5044",9315,-618,8e+05,0.3,80,275762
"3381",31756,-453,8300000,0.6,830,276592
"685",29856,870,1260000,0.775,126,276718
"1790",7351,346,1340000,0.65,134,276852
"3210",10188,-296,7e+05,0.6,70,276922
"764",28881,729,3760000,0.775,376,277298
"131",21005,1856,1700000,0.85,170,277468
"955",26104,705,490000,0.775,49,277517
"1742",30738,11.5,2690000,0.65,269,277786
"619",32110,521.666666666667,2480000,0.775,248,278034
"5100",31606,-698,1990000,0.3,199,278233
"971",40127,633,1440000,0.775,144,278377
"2627",36243,-191,3290000,0.6,329,278706
"300",28845,1167,1e+06,0.825,100,278806
"287",8026,1418,1e+06,0.825,100,278906
"6167",10743,-1040,980000,0.1,98,279004
"423",36751,920,1190000,0.775,119,279123
"1812",6916,87.5,1640000,0.65,164,279287
"637",31721,544.5,4390000,0.775,439,279726
"2302",790,443,640000,0.65,64,279790
"553",10564,673,2260000,0.775,226,280016
"939",40239,899,7e+05,0.775,70,280086
"1383",11260,381.333333333333,2170000,0.65,217,280303
"2691",13845,-459,490000,0.6,49,280352
"353",39962,1121,490000,0.825,49,280401
"2456",37325,-308,1620000,0.6,162,280563
"1969",5797,69,7e+05,0.65,70,280633
"2081",40760,10,7e+05,0.65,70,280703
"4894",33469,-657,6990000,0.3,699,281402
"2361",39002,174,8440000,0.65,844,282246
"3162",10333,-410,2750000,0.6,275,282521
"3194",33186,-441,5990000,0.6,599,283120
"1083",38688,842,7e+05,0.775,70,283190
"4897",10539,-985,7e+05,0.3,70,283260
"1364",33948,127,560000,0.65,56,283316
"1498",32846,257,7e+05,0.65,70,283386
"5071",31834,-545,1050000,0.3,105,283491
"2260",24978,376,7e+05,0.65,70,283561
"842",27564,522,1190000,0.775,119,283680
"4971",10314,-949,2630000,0.3,263,283943
"1060",38921,662,8e+05,0.775,80,284023
"6497",24484,-1017,560000,0.1,56,284079
"1597",32000,342,1260000,0.65,126,284205
"2727",13784,-319,1750000,0.6,175,284380
"609",32323,556,3810000,0.775,381,284761
"1736",31035,16,4250000,0.65,425,285186
"2280",22018,106,490000,0.65,49,285235
"3191",33209,-169,12810000,0.6,1281,286516
"5149",30979,-587,630000,0.3,63,286579
"582",32654,786,1e+06,0.775,100,286679
"5168",30964,-506,5050000,0.3,505,287184
"2186",26136,49,1e+06,0.65,100,287284
"4753",43306,-761,630000,0.3,63,287347
"3750",28938,-77,4140000,0.6,414,287761
"396",38945,1380,1e+06,0.825,100,287861
"237",32739,1299,490000,0.825,49,287910
"2865",34562,-217,8300000,0.6,830,288740
"3593",30672,-229,3100000,0.6,310,289050
"2637",14575,-306,3620000,0.6,362,289412
"3808",27950,-67,640000,0.6,64,289476
"2020",4555,384,490000,0.65,49,289525
"4289",16998,-831,1200000,0.3,120,289645
"212",33921,1349,1260000,0.825,126,289771
"2047",40926,154,3460000,0.65,346,290117
"4066",39050,-351,490000,0.6,49,290166
"5347",27583,-673,1360000,0.3,136,290302
"1950",41895,250,560000,0.65,56,290358
"2155",2668,267,630000,0.65,63,290421
"3448",8626,-459,490000,0.6,49,290470
"316",41035,1006,1190000,0.825,119,290589
"385",25222,1043,3330000,0.825,333,290922
"6210",10282,-1101.5,2190000,0.1,219,291141
"3743",28723,-462.666666666667,11950000,0.6,1195,292336
"3175",33011,-97,640000,0.6,64,292400
"87",11603,1718,8e+05,0.85,80,292480
"2328",38962,122,560000,0.65,56,292536
"392",24332,1351,3620000,0.825,362,292898
"2146",2750,332,560000,0.65,56,292954
"3376",31842,-264,1800000,0.6,180,293134
"643",31502,881,4110000,0.775,411,293545
"403",433,1413,560000,0.825,56,293601
"3857",40796,-175,1e+06,0.6,100,293701
"5042",32189,-627,1700000,0.3,170,293871
"4943",33185,-696,2260000,0.3,226,294097
"3460",42569,-367,4010000,0.6,401,294498
"1353",43201,326,1500000,0.65,150,294648
"999",39808,554,720000,0.775,72,294720
"6734",14160,-1864,2190000,0.05,219,294939
"6410",40781,-1321,1190000,0.1,119,295058
"5709",36993,-1404,7e+05,0.1,70,295128
"1166",43749,173,560000,0.65,56,295184
"3886",3260,-260,1700000,0.6,170,295354
"2330",24225,205,7e+05,0.65,70,295424
"387",24603,1119,560000,0.825,56,295480
"3056",10809,-269,2750000,0.6,275,295755
"97",32631,1503.2,4560000,0.85,456,296211
"1573",9435,356,1700000,0.65,170,296381
"1159",36396,228,1190000,0.65,119,296500
"3851",4752,-42,560000,0.6,56,296556
"5545",189,-984,1350000,0.3,135,296691
"5443",25579,-568,7e+05,0.3,70,296761
"1359",11657,70,1260000,0.65,126,296887
"817",28062,658,720000,0.775,72,296959
"2596",14814,-413.666666666667,1990000,0.6,199,297158
"1439",33216,322,1190000,0.65,119,297277
"2475",17292,-312.857142857143,12080000,0.6,1208,298485
"6078",11843,-1334.5,1270000,0.1,127,298612
"2618",14580,-297,640000,0.6,64,298676
"3285",32734,-432,2750000,0.6,275,298951
"2132",26354,238,490000,0.65,49,299000
"3307",32468,-440.5,1490000,0.6,149,299149
"2671",35858,-292,3110000,0.6,311,299460
"4418",36536,-854,560000,0.3,56,299516
"885",22961,601,2550000,0.775,255,299771
"5075",31886,-571,1700000,0.3,170,299941
"2109",3896,32,560000,0.65,56,299997
"1319",34294,282,7540000,0.65,754,300751
"84",34249,1768,1680000,0.85,168,300919
"4292",16774,-841.5,1290000,0.3,129,301048
"1976",28319,388.5,5190000,0.65,519,301567
"2351",24105,55,640000,0.65,64,301631
"3484",8139,-301,630000,0.6,63,301694
"3916",19668,-387,560000,0.6,56,301750
"5273",28769,-923,8e+05,0.3,80,301830
"675",29935,853,1400000,0.775,140,301970
"3500",8118,-198.5,2170000,0.6,217,302187
"3437",8698,-450,7e+05,0.6,70,302257
"5407",26407,-732,3500000,0.3,350,302607
"147",24918,1595,3810000,0.85,381,302988
"2149",40507,419,560000,0.65,56,303044
"436",36229,852,7e+05,0.775,70,303114
"3839",4584,-443,7e+05,0.6,70,303184
"6475",25278,-1046,630000,0.1,63,303247
"628",31731,718,560000,0.775,56,303303
"164",23097,1342,720000,0.825,72,303375
"3896",26491,-311,3530000,0.6,353,303728
"937",40274,945,490000,0.775,49,303777
"446",35914,591,1190000,0.775,119,303896
"1154",43844,99,1620000,0.65,162,304058
"3221",32834,-489,1e+06,0.6,100,304158
"3483",8134,-243.333333333333,2360000,0.6,236,304394
"2268",39656,168,1800000,0.65,180,304574
"2496",17008,-76,7e+05,0.6,70,304644
"4659",12657,-703,1440000,0.3,144,304788
"3017",33646,-387,1190000,0.6,119,304907
"94",9800,1663,560000,0.85,56,304963
"2545",36488,-484,9e+05,0.6,90,305053
"1974",28304,67,1700000,0.65,170,305223
"3800",20951,-125,720000,0.6,72,305295
"3563",30397,-474,1190000,0.6,119,305414
"2172",40458,246.5,3960000,0.65,396,305810
"4025",1146,-480,8e+05,0.6,80,305890
"3217",32811,-406.5,1700000,0.6,170,306060
"879",27171,512.5,8010000,0.775,801,306861
"718",6800,940,1260000,0.775,126,306987
"3544",7914,-121,1920000,0.6,192,307179
"2891",34235,-34,3890000,0.6,389,307568
"1772",7656,457,1890000,0.65,189,307757
"3363",9209,-23.6666666666667,3760000,0.6,376,308133
"3287",9695,-239,2260000,0.6,226,308359
"2558",15454,-196.333333333333,2060000,0.6,206,308565
"3625",29962,-393,7e+05,0.6,70,308635
"2205",26017,196,1130000,0.65,113,308748
"16",40036,2858,3060000,0.925,306,309054
"4508",35773,-526,3840000,0.3,384,309438
"4138",23875,-223,7e+05,0.6,70,309508
"679",29626,729,8e+05,0.775,80,309588
"2643",21657,-162,720000,0.6,72,309660
"1939",5895,440,560000,0.65,56,309716
"4139",23874,-498,1750000,0.6,175,309891
"600",32296,599,490000,0.775,49,309940
"565",10409,628,490000,0.775,49,309989
"3469",8227,-301,640000,0.6,64,310053
"3715",42099,-364,1e+06,0.6,100,310153
"1601",31909,438.5,2140000,0.65,214,310367
"3198",10230,-339,7e+05,0.6,70,310437
"5036",9440,-858,560000,0.3,56,310493
"746",42086,584,7e+05,0.775,70,310563
"729",6340,657,1500000,0.775,150,310713
"3659",29833,-12,2250000,0.6,225,310938
"570",42904,700,1900000,0.775,190,311128
"2129",26375,50,2060000,0.65,206,311334
"2096",26625,433,490000,0.65,49,311383
"5386",26639,-813,560000,0.3,56,311439
"555",21404,588,2330000,0.775,233,311672
"953",40141,504,560000,0.775,56,311728
"2074",26815,253,8e+05,0.65,80,311808
"2055",4127,418,1e+06,0.65,100,311908
"502",34213,893,9e+05,0.775,90,311998
"254",42851,1243,10420000,0.825,1042,313040
"4597",13577,-505,2190000,0.3,219,313259
"1779",7784,469,8e+05,0.65,80,313339
"1472",32940,497,560000,0.65,56,313395
"361",25749,1119,1700000,0.825,170,313565
"1647",8812,105,7e+05,0.65,70,313635
"787",5556,656,8e+05,0.775,80,313715
"1591",42780,19,1560000,0.65,156,313871
"5521",474,-891,1e+06,0.3,100,313971
"728",29220,686,2820000,0.775,282,314253
"4564",13778,-600,7e+05,0.3,70,314323
"992",25844,725,1190000,0.775,119,314442
"2932",33935,-464,1e+06,0.6,100,314542
"2091",26709,131,1400000,0.65,140,314682
"2357",24073,292,9e+05,0.65,90,314772
"4537",35595,-726,560000,0.3,56,314828
"864",4249,749,640000,0.775,64,314892
"3367",31975,-434.5,1270000,0.6,127,315019
"5043",9350,-850,8e+05,0.3,80,315099
"4036",24640,-418,7e+05,0.6,70,315169
"1057",38948,782,1430000,0.775,143,315312
"2857",12115,-119,2060000,0.6,206,315518
"3012",43170,-385,2820000,0.6,282,315800
"3124",21414,-444,8e+05,0.6,80,315880
"2213",1752,423,490000,0.65,49,315929
"1928",28712,360.5,1290000,0.65,129,316058
"1238",13929,400,1640000,0.65,164,316222
"1378",11350,253.5,2760000,0.65,276,316498
"3060",43040,-218,7e+05,0.6,70,316568
"3364",32065,-162.5,3460000,0.6,346,316914
"3378",23732,-170,1260000,0.6,126,317040
"1191",14234,299,1190000,0.65,119,317159
"4983",10110,-615,2190000,0.3,219,317378
"598",21353,970,560000,0.775,56,317434
"1668",8706,452,1260000,0.65,126,317560
"3166",32990,-470,720000,0.6,72,317632
"855",27121,835,2e+06,0.775,200,317832
"767",5910,710,1050000,0.775,105,317937
"5085",31528,-875,8e+05,0.3,80,318017
"4740",11836,-632,3160000,0.3,316,318333
"4903",10613,-525,1260000,0.3,126,318459
"4106",38727,-478,1e+06,0.6,100,318559
"5947",35681,-1069,7e+05,0.1,70,318629
"4046",39572,-418,2090000,0.6,209,318838
"3637",29566,-160,560000,0.6,56,318894
"2251",39782,402,1360000,0.65,136,319030
"2566",44385,-42,560000,0.6,56,319086
"3262",9976,-486,9e+05,0.6,90,319176
"1964",28799,229.5,6780000,0.65,678,319854
"956",1947,649,560000,0.775,56,319910
"3234",32837,-297,630000,0.6,63,319973
"4090",38781,-469,1e+06,0.6,100,320073
"1877",6286,260.666666666667,1750000,0.65,175,320248
"1053",39042,848,1120000,0.775,112,320360
"4076",24205,-258,1260000,0.6,126,320486
"812",28174,556,560000,0.775,56,320542
"3427",8681,-315.5,2550000,0.6,255,320797
"451",43641,765,2160000,0.775,216,321013
"550",33091,830,1e+06,0.775,100,321113
"2944",11497,-293,1e+06,0.6,100,321213
"938",40209,747.5,1750000,0.775,175,321388
"3315",32269,-3,1290000,0.6,129,321517
"3567",30679,-2,3750000,0.6,375,321892
"4322",36797,-517.5,2500000,0.3,250,322142
"1230",35553,230,7e+05,0.65,70,322212
"3876",27101,-128,6880000,0.6,688,322900
"5589",18291,-1055,490000,0.1,49,322949
"4699",12241,-584,490000,0.3,49,322998
"3140",10589,-297.333333333333,2780000,0.6,278,323276
"1653",31612,388.5,1260000,0.65,126,323402
"4467",36055,-864,720000,0.3,72,323474
"134",20967,1878,640000,0.85,64,323538
"1782",7089,172,3060000,0.65,306,323844
"1998",41504,265,1360000,0.65,136,323980
"5102",31609,-914,2160000,0.3,216,324196
"412",38783,1278,2090000,0.825,209,324405
"2653",43715,-367,560000,0.6,56,324461
"577",32912,631,4560000,0.775,456,324917
"413",24055,1356,3550000,0.825,355,325272
"4379",15477,-779.666666666667,4980000,0.3,498,325770
"809",28213,658,1260000,0.775,126,325896
"1315",11893,448,640000,0.65,64,325960
"422",36894,856.666666666667,4600000,0.775,460,326420
"329",3517,1446,1610000,0.825,161,326581
"566",32939,744,16250000,0.775,1625,328206
"3435",31499,-351,7e+05,0.6,70,328276
"2954",11446,-251,1400000,0.6,140,328416
"3061",10696,-218,490000,0.6,49,328465
"1706",30975,236.5,1280000,0.65,128,328593
"526",43205,671,7e+05,0.775,70,328663
"303",28822,1003,2140000,0.825,214,328877
"2835",34635,-357,560000,0.6,56,328933
"1141",36893,66,7e+05,0.65,70,329003
"1232",13882,317,490000,0.65,49,329052
"1609",42753,129,1700000,0.65,170,329222
"395",39348,1327,9020000,0.825,902,330124
"1485",32909,467,560000,0.65,56,330180
"4782",34155,-562,490000,0.3,49,330229
"488",12794,850,560000,0.775,56,330285
"2498",36970,-307,640000,0.6,64,330349
"614",32275,987,1400000,0.775,140,330489
"2406",38058,-480,1750000,0.6,175,330664
"5014",9947,-521.5,1190000,0.3,119,330783
"3415",31466,-384.5,2240000,0.6,224,331007
"5097",31490,-608,560000,0.3,56,331063
"2110",26593,176,5050000,0.65,505,331568
"1410",10985,43,3250000,0.65,325,331893
"5238",6347,-892,7e+05,0.3,70,331963
"2182",40229,158,7e+05,0.65,70,332033
"2316",39081,330,630000,0.65,63,332096
"2782",35011,-165,1190000,0.6,119,332215
"3944",2267,-249,8e+05,0.6,80,332295
"591",32610,649,3750000,0.775,375,332670
"535",21497,525,1800000,0.775,180,332850
"3616",29915,-79,7e+05,0.6,70,332920
"4053",24309,-93,640000,0.6,64,332984
"1932",42088,235,4410000,0.65,441,333425
"4279",36986,-959,490000,0.3,49,333474
"1283",34616,18,560000,0.65,56,333530
"2537",15727,-310,2820000,0.6,282,333812
"467",13390,535.5,1400000,0.775,140,333952
"364",1459,1296,8e+05,0.825,80,334032
"310",41433,1142,640000,0.825,64,334096
"1224",14043,269,8e+05,0.65,80,334176
"677",21186,943,8e+05,0.775,80,334256
"4041",24501,-418,8e+05,0.6,80,334336
"2314",24288,283,2200000,0.65,220,334556
"3684",6308,-57,7e+05,0.6,70,334626
"1101",38541,640,1500000,0.775,150,334776
"1911",5971,39,7e+05,0.65,70,334846
"670",7300,753,7e+05,0.775,70,334916
"5476",39832,-689,6e+06,0.3,600,335516
"4135",23,-175,490000,0.6,49,335565
"2003",41449,171,560000,0.65,56,335621
"3954",40260,-101,7e+05,0.6,70,335691
"2619",36005,-297,8e+05,0.6,80,335771
"4769",43290,-632,1e+06,0.3,100,335871
"205",12233,1007,1440000,0.825,144,336015
"5477",1310,-538,8e+05,0.3,80,336095
"1308",34316,415.5,4230000,0.65,423,336518
"1470",10318,311,2550000,0.65,255,336773
"324",4333,1421,7e+05,0.825,70,336843
"4333",16034,-929.666666666667,2550000,0.3,255,337098
"1520",10069,85,1500000,0.65,150,337248
"3894",26519,-341,4420000,0.6,442,337690
"5856",14907,-1058,7e+05,0.1,70,337760
"3773",5725,-168,7e+05,0.6,70,337830
"1342",34059,86,1360000,0.65,136,337966
"2066",26896,310,7e+05,0.65,70,338036
"1804",7054,330,7e+05,0.65,70,338106
"3528",30592,-337,630000,0.6,63,338169
"1474",32992,190,5060000,0.65,506,338675
"1301",11931,55.5,1120000,0.65,112,338787
"2901",34215,-11,2720000,0.6,272,339059
"4807",11254,-929,3200000,0.3,320,339379
"962",19009,740,8e+05,0.775,80,339459
"6348",5479,-1480,2200000,0.1,220,339679
"3963",2086,-326,1700000,0.6,170,339849
"120",8102,1881,2890000,0.85,289,340138
"5780",15928,-1215,1820000,0.1,182,340320
"5722",36936,-1259.66666666667,2300000,0.1,230,340550
"4865",33335,-623,7e+05,0.3,70,340620
"3913",40645,-104,7690000,0.6,769,341389
"1757",7365,222,1e+06,0.65,100,341489
"3464",8599,-320,560000,0.6,56,341545
"5681",21967,-1133,560000,0.1,56,341601
"3865",3864,-327,490000,0.6,49,341650
"3401",31538,-311,8e+05,0.6,80,341730
"4819",11170,-695,3460000,0.3,346,342076
"3311",42828,-153.5,1400000,0.6,140,342216
"2817",12460,-455.666666666667,6020000,0.6,602,342818
"5124",8282,-897,640000,0.3,64,342882
"5763",16488,-1298,8e+05,0.1,80,342962
"487",34604,850,8e+05,0.775,80,343042
"5472",25169,-529,560000,0.3,56,343098
"6399",27037,-1139,2250000,0.1,225,343323
"3157",10554,-466,3580000,0.6,358,343681
"1586",9292,147,1190000,0.65,119,343800
"4375",43873,-788,2060000,0.3,206,344006
"6258",8669,-1391,1500000,0.1,150,344156
"186",13852,1050,1260000,0.825,126,344282
"2464",37147,-214,490000,0.6,49,344331
"6205",10326,-1293,1360000,0.1,136,344467
"6836",10645,-1777,7e+05,0.05,70,344537
"1144",15753,163,560000,0.65,56,344593
"3720",29047,-386,1890000,0.6,189,344782
"682",6883,849,8e+05,0.775,80,344862
"575",42903,700,4880000,0.775,488,345350
"2548",36597,-365,1350000,0.6,135,345485
"3257",10034,-58,7e+05,0.6,70,345555
"3246",32810,-424,7e+05,0.6,70,345625
"998",39863,639,8e+05,0.775,80,345705
"3231",32890,-92,1190000,0.6,119,345824
"2615",14775,-306,1050000,0.6,105,345929
"5354",4489,-900.666666666667,1850000,0.3,185,346114
"1118",18303,29,7e+05,0.65,70,346184
"1904",28914,465.5,1400000,0.65,140,346324
"5369",40795,-785,1890000,0.3,189,346513
"3103",10713,-441,1820000,0.6,182,346695
"4652",34937,-860,560000,0.3,56,346751
"166",36318,1375,490000,0.825,49,346800
"4235",37265,-945,560000,0.3,56,346856
"527",11293,526,1e+06,0.775,100,346956
"1032",24527,771,1930000,0.775,193,347149
"1222",35706,470.5,3e+06,0.65,300,347449
"2912",11832,-49,1620000,0.6,162,347611
"5184",42339,-556,1190000,0.3,119,347730
"5512",672,-598,7e+05,0.3,70,347800
"380",1118,1208,490000,0.825,49,347849
"1156",23872,287,1260000,0.65,126,347975
"881",26707,560,630000,0.775,63,348038
"987",25842,864,560000,0.775,56,348094
"1365",33894,265,560000,0.65,56,348150
"5074",31904,-735,1750000,0.3,175,348325
"3281",9987,-217,1990000,0.6,199,348524
"3196",32987,-173,3110000,0.6,311,348835
"3097",10636,-475,490000,0.6,49,348884
"2724",35431,-228,8e+05,0.6,80,348964
"3891",3342,-443,8e+05,0.6,80,349044
"4134",38407,-412,1e+06,0.6,100,349144
"98",32671,1717,2900000,0.85,290,349434
"5400",26636,-1000,3180000,0.3,318,349752
"1869",29508,158,2240000,0.65,224,349976
"67",24014,2215,7e+05,0.9,70,350046
"1690",42445,388,1350000,0.65,135,350181
"5931",14281,-1266,1050000,0.1,105,350286
"2131",26410,477,2480000,0.65,248,350534
"2529",15953,-48.5,1120000,0.6,112,350646
"1153",43851,13,1440000,0.65,144,350790
"24",35518,2117,1530000,0.9,153,350943
"5015",32707,-721,2550000,0.3,255,351198
"1121",18065,84,7e+05,0.65,70,351268
"452",35682,839,1700000,0.775,170,351438
"4309",36850,-784,7e+05,0.3,70,351508
"556",21400,588,720000,0.775,72,351580
"6234",9453,-1057,8e+05,0.1,80,351660
"1692",31503,281,5760000,0.65,576,352236
"4048",777,-175,810000,0.6,81,352317
"1236",13842,230,560000,0.65,56,352373
"4695",12271,-732.333333333333,5360000,0.3,536,352909
"2801",34766,-199,1360000,0.6,136,353045
"5590",38116,-1275,4260000,0.1,426,353471
"6327",6074,-1352,560000,0.1,56,353527
"1676",8226,8.5,1340000,0.65,134,353661
"4459",36116,-611,8e+05,0.3,80,353741
"3767",5949,-24,1360000,0.6,136,353877
"2803",34763,-270,560000,0.6,56,353933
"1751",30814,272,3620000,0.65,362,354295
"890",3558,556.5,1280000,0.775,128,354423
"5198",30563,-845,5680000,0.3,568,354991
"1816",6989,294,560000,0.65,56,355047
"2165",2354,168,8e+05,0.65,80,355127
"153",39535,1559,1700000,0.85,170,355297
"498",34071,822,720000,0.775,72,355369
"261",42633,1085,640000,0.825,64,355433
"1758",7301,45,7e+05,0.65,70,355503
"4964",10272,-650,2190000,0.3,219,355722
"608",42789,548.5,2190000,0.775,219,355941
"1259",13110,39,3400000,0.65,340,356281
"710",29242,787,7e+05,0.775,70,356351
"92",32835,1981,3690000,0.85,369,356720
"76",13302,1533.25,2380000,0.85,238,356958
"1919",28893,349,2750000,0.65,275,357233
"3742",5865,-35,3140000,0.6,314,357547
"3627",7052,-333,2890000,0.6,289,357836
"1219",13990,306,7e+05,0.65,70,357906
"2943",11635,-478,1260000,0.6,126,358032
"1423",10641,132,7e+05,0.65,70,358102
"1618",31947,282,1500000,0.65,150,358252
"871",4580,714,1850000,0.775,185,358437
"4501",14107,-829,560000,0.3,56,358493
"36",21398,2008,6e+06,0.9,600,359093
"1161",44388,366,490000,0.65,49,359142
"2309",39114,440,7e+05,0.65,70,359212
"911",22811,733,8e+05,0.775,80,359292
"4981",10324,-764,1e+06,0.3,100,359392
"475",35071,697.5,5030000,0.775,503,359895
"4405",15287,-846,7e+05,0.3,70,359965
"2017",27856,372,1700000,0.65,170,360135
"1881",29746,119,9700000,0.65,970,361105
"449",13950,885,3440000,0.775,344,361449
"1855",6739,487.5,1190000,0.65,119,361568
"388",39479,1387,630000,0.825,63,361631
"3958",40202,-431,490000,0.6,49,361680
"1575",32695,309,4300000,0.65,430,362110
"810",20986,722,1050000,0.775,105,362215
"4649",34645,-697,2330000,0.3,233,362448
"1157",36451,49,1890000,0.65,189,362637
"1488",32922,308.5,1260000,0.65,126,362763
"138",2649,1519.33333333333,4410000,0.85,441,363204
"2723",13740,-50,5890000,0.6,589,363793
"2363",24166,176,1750000,0.65,175,363968
"2170",40340,194,7e+05,0.65,70,364038
"304",41831,1012,640000,0.825,64,364102
"1681",31233,325.5,1430000,0.65,143,364245
"1058",24210,809,1500000,0.775,150,364395
"3016",33711,-341,2550000,0.6,255,364650
"4589",35227,-782,8e+05,0.3,80,364730
"4051",39377,-297,720000,0.6,72,364802
"4951",10536,-546,1700000,0.3,170,364972
"1795",7068,465,1120000,0.65,112,365084
"6411",26919,-1122,1800000,0.1,180,365264
"3908",2854,-356,7e+05,0.6,70,365334
"4294",16946,-602,3140000,0.3,314,365648
"749",28865,869,1800000,0.775,180,365828
"6939",28056,-1574,8e+05,0.05,80,365908
"6173",33142,-1247,630000,0.1,63,365971
"3692",29137,-277,7e+05,0.6,70,366041
"4590",35305,-782,9e+05,0.3,90,366131
"972",1930,738,720000,0.775,72,366203
"2555",43846,-363,9e+05,0.6,90,366293
"3904",19680,-278,560000,0.6,56,366349
"323",4267,1345,7e+05,0.825,70,366419
"762",6092,544,1440000,0.775,144,366563
"3719",42087,-20,560000,0.6,56,366619
"2796",23768,-134,2960000,0.6,296,366915
"3951",40300,-149,7e+05,0.6,70,366985
"246",9710,1451,640000,0.825,64,367049
"820",41408,776,1360000,0.775,136,367185
"2971",11221,-296,1260000,0.6,126,367311
"3265",32712,-190,2260000,0.6,226,367537
"6261",31398,-1376,1190000,0.1,119,367656
"2571",15361,-223,1200000,0.6,120,367776
"2402",18705,-364,640000,0.6,64,367840
"2745",13640,-179,1e+06,0.6,100,367940
"1912",6157,481.5,2760000,0.65,276,368216
"741",42096,602,1260000,0.775,126,368342
"3434",8848,-351,1360000,0.6,136,368478
"2501",16944,-291,560000,0.6,56,368534
"1468",10287,401,8e+05,0.65,80,368614
"334",40514,1190.66666666667,2660000,0.825,266,368880
"1662",21303,185,1190000,0.65,119,368999
"920",26240,791,560000,0.775,56,369055
"4950",33029,-956,1990000,0.3,199,369254
"393",39225,1209,2500000,0.825,250,369504
"3440",8527,-259.5,1260000,0.6,126,369630
"2348",473,258.333333333333,3300000,0.65,330,369960
"1249",35535,270,12040000,0.65,1204,371164
"5264",28824,-705,1e+06,0.3,100,371264
"1268",34745,395,560000,0.65,56,371320
"1504",32863,283,2550000,0.65,255,371575
"1355",11355,401,1e+06,0.65,100,371675
"4933",21406,-539,2440000,0.3,244,371919
"3935",2373,-132,8e+05,0.6,80,371999
"2617",14609,-138.2,5940000,0.6,594,372593
"546",10740,566,2060000,0.775,206,372799
"1776",30285,125,1990000,0.65,199,372998
"4489",43724,-617,5690000,0.3,569,373567
"2269",39660,140,7e+05,0.65,70,373637
"2289",24589,456,1700000,0.65,170,373807
"4499",35891,-912,7e+05,0.3,70,373877
"283",29855,1018,1050000,0.825,105,373982
"4251",37170,-626,560000,0.3,56,374038
"2758",13300,-142,560000,0.6,56,374094
"760",28805,869,8e+05,0.775,80,374174
"5362",3966,-803,560000,0.3,56,374230
"65",39604,2394,9e+05,0.9,90,374320
"1006",1422,526,560000,0.775,56,374376
"6102",11409,-1381,1750000,0.1,175,374551
"4565",35513,-726,2250000,0.3,225,374776
"3677",29279,-296,490000,0.6,49,374825
"4417",15188,-762,490000,0.3,49,374874
"2130",22825,444,490000,0.65,49,374923
"4698",13014,-817,2240000,0.3,224,375147
"215",11368,1074,7e+05,0.825,70,375217
"1704",42376,457.75,2930000,0.65,293,375510
"1870",29376,372,2380000,0.65,238,375748
"3280",9931,-98,560000,0.6,56,375804
"1350",33955,26,1500000,0.65,150,375954
"5338",27985,-970,6e+06,0.3,600,376554
"3302",9782,-11,490000,0.6,49,376603
"2572",36468,-380,1050000,0.6,105,376708
"3705",29937,-241,25610000,0.6,2561,379269
"564",33007,646,560000,0.775,56,379325
"1381",11244,357,490000,0.65,49,379374
"2777",13122,-150,2650000,0.6,265,379639
"199",43510,1134,4470000,0.825,447,380086
"5232",21132,-833,7e+05,0.3,70,380156
"202",12729,1287.5,1280000,0.825,128,380284
"654",42473,651.25,2550000,0.775,255,380539
"4509",14033,-624.666666666667,3260000,0.3,326,380865
"128",28921,1638,640000,0.85,64,380929
"4922",10482,-659,1500000,0.3,150,381079
"1729",30708,250,9e+05,0.65,90,381169
"1028",25609,672,11740000,0.775,1174,382343
"3852",27014,-216,640000,0.6,64,382407
"5241",42122,-607,490000,0.3,49,382456
"2124",26416,238,560000,0.65,56,382512
"2822",34703,-280,2400000,0.6,240,382752
"7",35270,2804,2260000,0.925,226,382978
"5152",8179,-761,1360000,0.3,136,383114
"2894",34152,-127.333333333333,4730000,0.6,473,383587
"1979",41728,159,1190000,0.65,119,383706
"4003",25573,-13,560000,0.6,56,383762
"29",10369,2034,1760000,0.9,176,383938
"1625",31743,388,640000,0.65,64,384002
"5361",3999,-803,8e+05,0.3,80,384082
"4900",33324,-547,2380000,0.3,238,384320
"5132",31214,-810,8e+05,0.3,80,384400
"371",25464,1296,2470000,0.825,247,384647
"5778",23148,-1099,2190000,0.1,219,384866
"2852",12016,-34,560000,0.6,56,384922
"3967",1933,-210,7e+05,0.6,70,384992
"104",31690,1588,560000,0.85,56,385048
"1005",39801,714,640000,0.775,64,385112
"2100",22940,38,1e+06,0.65,100,385212
"174",14215,1113.66666666667,2120000,0.825,212,385424
"4620",35200,-813,3590000,0.3,359,385783
"4766",11823,-622,8e+05,0.3,80,385863
"4792",33803,-562,560000,0.3,56,385919
"3396",31641,-183,7e+05,0.6,70,385989
"4382",36470,-626,1990000,0.3,199,386188
"2097",26637,393,2190000,0.65,219,386407
"638",42667,675,4050000,0.775,405,386812
"684",21172,670,2760000,0.775,276,387088
"1784",7336,158,560000,0.65,56,387144
"4084",38853,-108,2160000,0.6,216,387360
"1961",44230,250,1700000,0.65,170,387530
"2786",35033,-3,1700000,0.6,170,387700
"5399",40616,-550,720000,0.3,72,387772
"1155",15464,70,720000,0.65,72,387844
"5277",5774,-533,1820000,0.3,182,388026
"3327",32687,-97,13810000,0.6,1381,389407
"2057",4208,418,8e+05,0.65,80,389487
"4014",25244,-465,9e+05,0.6,90,389577
"5320",27960,-962,630000,0.3,63,389640
"1185",36059,309,1990000,0.65,199,389839
"799",28307,658,2400000,0.775,240,390079
"74",35328,1817,560000,0.85,56,390135
"5467",25535,-895,1700000,0.3,170,390305
"2824",12454,-241,1440000,0.6,144,390449
"5179",8060,-587,1260000,0.3,126,390575
"3185",32972,-406,4820000,0.6,482,391057
"5550",158,-640,1120000,0.3,112,391169
"2082",3664,131,560000,0.65,56,391225
"2218",40025,393,8e+05,0.65,80,391305
"2837",34753,-147,7620000,0.6,762,392067
"2638",36047,-86,9e+05,0.6,90,392157
"1229",35605,270,7e+05,0.65,70,392227
"7144",16349,-3228,7e+05,0.001,70,392297
"54",28048,2175,8e+05,0.9,80,392377
"4820",33647,-754.5,2980000,0.3,298,392675
"2833",12404,-39,1360000,0.6,136,392811
"3203",32885,-342,630000,0.6,63,392874
"3641",42226,-249,1050000,0.6,105,392979
"6455",25889,-1036,8e+05,0.1,80,393059
"2624",21681,-479,8e+05,0.6,80,393139
"1073",404,858,7e+05,0.775,70,393209
"3806",5085,-130,1280000,0.6,128,393337
"2143",2918,267,490000,0.65,49,393386
"2095",40676,360,1190000,0.65,119,393505
"6154",33294,-1007,1500000,0.1,150,393655
"3326",32244,-193,1560000,0.6,156,393811
"547",33292,959,980000,0.775,98,393909
"3837",41450,-120,7410000,0.6,741,394650
"2783",13131,-385,7e+05,0.6,70,394720
"152",1092,1559,1360000,0.85,136,394856
"190",43735,1170,11710000,0.825,1171,396027
"653",8598,724,1360000,0.775,136,396163
"3462",31161,-71,2260000,0.6,226,396389
"1321",43298,7,3120000,0.65,312,396701
"4100",38710,-469,7e+05,0.6,70,396771
"3976",1869,-491,560000,0.6,56,396827
"1038",24340,883,630000,0.775,63,396890
"606",9274,621,560000,0.775,56,396946
"1490",33064,26,4680000,0.65,468,397414
"825",41288,814,720000,0.775,72,397486
"1369",43239,135,7e+06,0.65,700,398186
"3561",7468,-354,560000,0.6,56,398242
"4008",39835,-467,640000,0.6,64,398306
"382",23422,1054,7e+05,0.825,70,398376
"3819",41335,-124.5,2820000,0.6,282,398658
"1373",11470,47,490000,0.65,49,398707
"3386",8822,-276,7e+05,0.6,70,398777
"3972",26152,-499.5,9300000,0.6,930,399707
"1117",37852,312,7e+05,0.65,70,399777
"1628",32601,459,16190000,0.65,1619,401396
"3371",8986,-328,640000,0.6,64,401460
"6139",10738,-1203,720000,0.1,72,401532
"6182",33202,-1200,1e+06,0.1,100,401632
"6379",4916,-1458,490000,0.1,49,401681
"5774",16249,-1010,7e+05,0.1,70,401751
"3807",41187,-190,720000,0.6,72,401823
"4823",33912,-833.5,6450000,0.3,645,402468
"959",40192,739,2850000,0.775,285,402753
"2340",38867,55,490000,0.65,49,402802
"695",29784,979,3010000,0.775,301,403103
"3888",3296,-311,1e+06,0.6,100,403203
"332",22763,1145,9e+05,0.825,90,403293
"2450",17601,-458,640000,0.6,64,403357
"4581",35358,-813,1360000,0.3,136,403493
"5493",936,-596,560000,0.3,56,403549
"1873",42180,140,1820000,0.65,182,403731
"2384",38522,11.5,1400000,0.65,140,403871
"3092",33336,-372,3620000,0.6,362,404233
"1317",34243,166,560000,0.65,56,404289
"5822",36466,-1306,8e+05,0.1,80,404369
"1970",28907,220,2260000,0.65,226,404595
"1085",24018,537,1800000,0.775,180,404775
"4113",259,-314,490000,0.6,49,404824
"4366",15566,-657,9960000,0.3,996,405820
"3517",30972,-269,1990000,0.6,199,406019
"27",35005,2412,9e+05,0.9,90,406109
"2825",12685,-236,9e+05,0.6,90,406199
"386",24534,1119,1330000,0.825,133,406332
"838",41459,781,5640000,0.775,564,406896
"2140",26323,112,8e+05,0.65,80,406976
"3751",6116,-132,8e+05,0.6,80,407056
"2009",28137,190,3750000,0.65,375,407431
"1990",28171,265,640000,0.65,64,407495
"3965",40146,-144,7e+05,0.6,70,407565
"2858",34644,-210,3050000,0.6,305,407870
"3744",41955,-317.5,9200000,0.6,920,408790
"2313",24273,173,1e+06,0.65,100,408890
"5066",31780,-725,490000,0.3,49,408939
"969",26133,526,4910000,0.775,491,409430
"4213",37656,-981,3040000,0.3,304,409734
"3557",30957,-81,2410000,0.6,241,409975
"2293",845,187,9e+05,0.65,90,410065
"3608",30153,-319,7160000,0.6,716,410781
"3127",10532,-481,3800000,0.6,380,411161
"1550",32568,103,1e+06,0.65,100,411261
"1652",8788,244,1990000,0.65,199,411460
"926",40368,665,560000,0.775,56,411516
"798",23011,762,1e+06,0.775,100,411616
"1710",31068,386,2080000,0.65,208,411824
"159",24113,1586,640000,0.85,64,411888
"2298",24321,495,630000,0.65,63,411951
"1621",9062,219,640000,0.65,64,412015
"4102",38718,-13.5,1260000,0.6,126,412141
"2050",40835,62,8e+05,0.65,80,412221
"848",27312,610,1190000,0.775,119,412340
"664",30388,669.5,1360000,0.775,136,412476
"660",8274,763.5,1520000,0.775,152,412628
"2275",1020,282,1290000,0.65,129,412757
"1133",17626,320,2880000,0.65,288,413045
"2765",13239,-375,1190000,0.6,119,413164
"919",22655,965,9e+05,0.775,90,413254
"379",1361,1138,1400000,0.825,140,413394
"1525",9968,481,1750000,0.65,175,413569
"3537",8074,-150,640000,0.6,64,413633
"3589",7213,-471,8e+05,0.6,80,413713
"5530",23923,-632,560000,0.3,56,413769
"2927",43282,-19,8e+05,0.6,80,413849
"1548",32577,343,1e+06,0.65,100,413949
"3119",10454,-339.5,1500000,0.6,150,414099
"839",41041,726,560000,0.775,56,414155
"3784",28512,-47,4260000,0.6,426,414581
"1700",8110,52,720000,0.65,72,414653
"1211",35901,232,2400000,0.65,240,414893
"4015",25124,-38,720000,0.6,72,414965
"611",32692,674.25,18330000,0.775,1833,416798
"701",29523,718,4500000,0.775,450,417248
"6505",39162,-1359,1700000,0.1,170,417418
"3923",2691,-251,640000,0.6,64,417482
"2457",17819,-493,2e+06,0.6,200,417682
"3225",32921,-21,4650000,0.6,465,418147
"1569",9485,479,490000,0.65,49,418196
"2993",11193,-466,1700000,0.6,170,418366
"2266",22119,52,490000,0.65,49,418415
"2564",43878,-271,1930000,0.6,193,418608
"2136",2880,133,1500000,0.65,150,418758
"4944",10492,-710,2820000,0.3,282,419040
"1687",8276,157,8e+05,0.65,80,419120
"6425",3339,-1167,1360000,0.1,136,419256
"3934",40384,-211,1200000,0.6,120,419376
"539",33431,542,490000,0.775,49,419425
"2866",34310,-203,1700000,0.6,170,419595
"1885",6233,330,1e+06,0.65,100,419695
"4665",12352,-767,2250000,0.3,225,419920
"1187",36164,22,3770000,0.65,377,420297
"6461",1704,-1036,7e+05,0.1,70,420367
"5034",9759,-850,7e+05,0.3,70,420437
"83",34259,1839,3030000,0.85,303,420740
"2378",38632,421.5,1360000,0.65,136,420876
"3377",8850,-42,560000,0.6,56,420932
"6265",8586,-1092,560000,0.1,56,420988
"2574",15350,-239,2400000,0.6,240,421228
"1908",5985,377.5,2050000,0.65,205,421433
"2320",24266,477,7e+05,0.65,70,421503
"2367",373,292,1190000,0.65,119,421622
"4346",16140,-835,560000,0.3,56,421678
"3211",10248,-296,1700000,0.6,170,421848
"1695",8376,259,630000,0.65,63,421911
"4258",17306,-639,1820000,0.3,182,422093
"5927",14479,-1231,7e+05,0.1,70,422163
"5076",31644,-691,7e+05,0.3,70,422233
"1052",625,750,490000,0.775,49,422282
"5621",17936,-1415,7e+05,0.1,70,422352
"3612",7056,-100,8e+05,0.6,80,422432
"2198",26073,342,4250000,0.65,425,422857
"5225",6785,-964,7e+05,0.3,70,422927
"5600",38305,-1108,16830000,0.1,1683,424610
"6440",40371,-1090,1340000,0.1,134,424744
"1941",28699,249.5,1120000,0.65,112,424856
"313",41383,1142,2090000,0.825,209,425065
"2133",26352,238,560000,0.65,56,425121
"318",41327,1417,16650000,0.825,1665,426786
"1535",32777,416,640000,0.65,64,426850
"2603",14834,-484,1050000,0.6,105,426955
"3150",42939,-335,560000,0.6,56,427011
"416",205,1456.5,1490000,0.825,149,427160
"1954",28818,193,4600000,0.65,460,427620
"933",22454,615,560000,0.775,56,427676
"3425",8731,-367,2060000,0.6,206,427882
"2364",24041,335,7e+05,0.65,70,427952
"5070",8975,-574,1200000,0.3,120,428072
"3264",32724,-232,1800000,0.6,180,428252
"3263",9927,-109,1e+06,0.6,100,428352
"4657",12539,-678,1920000,0.3,192,428544
"1190",35962,49,1200000,0.65,120,428664
"4019",25100,-185,1050000,0.6,105,428769
"1489",42926,207,8e+05,0.65,80,428849
"912",2836,733,1e+06,0.775,100,428949
"3002",33690,-195,560000,0.6,56,429005
"442",14337,591,8e+05,0.775,80,429085
"4288",16962,-927,1200000,0.3,120,429205
"524",33753,986,4950000,0.775,495,429700
"3989",25935,-496,1e+06,0.6,100,429800
"2075",3958,176,1260000,0.65,126,429926
"3004",33590,-37.25,6410000,0.6,641,430567
"1886",6304,38,7e+05,0.65,70,430637
"1001",25368,721,1620000,0.775,162,430799
"322",4515,1229,2260000,0.825,226,431025
"2881",43320,-28.25,3270000,0.6,327,431352
"3059",33280,-218,560000,0.6,56,431408
"5956",43633,-1214,1e+06,0.1,100,431508
"1163",15107,297,1e+06,0.65,100,431608
"2194",40104,378,7e+05,0.65,70,431678
"1905",28856,7,560000,0.65,56,431734
"346",2101,1217.5,1260000,0.825,126,431860
"2741",35445,-159,1890000,0.6,189,432049
"3614",30157,-109,3230000,0.6,323,432372
"42",21310,2054,1190000,0.9,119,432491
"2054",26985,346,1500000,0.65,150,432641
"4895",10664,-991,7e+05,0.3,70,432711
"2113",26450,141,720000,0.65,72,432783
"4637",12798,-702,1750000,0.3,175,432958
"3619",42277,-411,2550000,0.6,255,433213
"3996",1632,-311,7e+05,0.6,70,433283
"2911",34043,-203,1990000,0.6,199,433482
"1207",14252,212,560000,0.65,56,433538
"982",40034,711,7e+05,0.775,70,433608
"3818",41138,-313,1440000,0.6,144,433752
"3714",42150,-117,3080000,0.6,308,434060
"4555",13794,-903.5,1640000,0.3,164,434224
"1136",17128,107,560000,0.65,56,434280
"251",32463,1451,1500000,0.825,150,434430
"10",41579,2996,8e+05,0.925,80,434510
"129",28827,1638,1610000,0.85,161,434671
"2137",2883,410,1e+06,0.65,100,434771
"3792",28251,-402,560000,0.6,56,434827
"5548",165,-633,8e+05,0.3,80,434907
"1639",31768,186,8e+05,0.65,80,434987
"5131",31078,-636,640000,0.3,64,435051
"916",26338,829,490000,0.775,49,435100
"3592",7315,-413,490000,0.6,49,435149
"2557",15357,-103,560000,0.6,56,435205
"2291",24339,480,630000,0.65,63,435268
"2836",34720,-352,1890000,0.6,189,435457
"6357",5305,-1426,7e+05,0.1,70,435527
"3864",40869,-456,3750000,0.6,375,435902
"588",32674,565,1500000,0.775,150,436052
"1589",9122,271,1500000,0.65,150,436202
"1331",34181,173,3050000,0.65,305,436507
"3077",10797,-80,7e+05,0.6,70,436577
"1995",28384,279,4810000,0.65,481,437058
"3591",30480,-354,1500000,0.6,150,437208
"6921",29136,-1996,7e+05,0.05,70,437278
"378",23465,1295,7e+05,0.825,70,437348
"3432",8697,-492,8e+05,0.6,80,437428
"3642",7121,-398,1360000,0.6,136,437564
"3052",33457,-36,1200000,0.6,120,437684
"5974",13801,-1301,640000,0.1,64,437748
"1843",42191,464,7e+05,0.65,70,437818
"1000",1469,941,2720000,0.775,272,438090
"3856",40805,-175,8e+05,0.6,80,438170
"3875",3591,-170,490000,0.6,49,438219
"336",2747,1329,720000,0.825,72,438291
"6886",42554,-1696,1190000,0.05,119,438410
"2616",36084,-268.75,5690000,0.6,569,438979
"931",40272,956,560000,0.775,56,439035
"4788",33886,-792,1360000,0.3,136,439171
"453",13775,549,560000,0.775,56,439227
"4891",10856,-696,7e+05,0.3,70,439297
"3277",10053,-346,7e+05,0.6,70,439367
"2301",39237,440,8e+05,0.65,80,439447
"1806",30211,114,4690000,0.65,469,439916
"2972",33701,-416.5,1290000,0.6,129,440045
"5684",17489,-1307,1610000,0.1,161,440206
"1376",11476,104,1120000,0.65,112,440318
"2200",1922,82,8e+05,0.65,80,440398
"4577",43574,-535,7e+05,0.3,70,440468
"5250",44259,-646.5,1290000,0.3,129,440597
"1895",29034,386,4740000,0.65,474,441071
"2791",34861,-196,8e+05,0.6,80,441151
"6391",4621,-1159.5,1260000,0.1,126,441277
"2252",23565,426,560000,0.65,56,441333
"1641",31656,105.5,1560000,0.65,156,441489
"461",35590,655,3860000,0.775,386,441875
"4676",34612,-786,630000,0.3,63,441938
"2349",508,363,8e+05,0.65,80,442018
"2746",13636,-174,2190000,0.6,219,442237
"3279",9982,-418,1340000,0.6,134,442371
"344",40236,1447,7e+05,0.825,70,442441
"2138",26358,74,2760000,0.65,276,442717
"607",42791,621,1190000,0.775,119,442836
"2190",26119,49,2060000,0.65,206,443042
"289",29811,1418,7e+05,0.825,70,443112
"1993",28126,471,560000,0.65,56,443168
"772",28574,640,1750000,0.775,175,443343
"1397",11139,323,1700000,0.65,170,443513
"4047",39339,-413,630000,0.6,63,443576
"4157",18601,-658,720000,0.3,72,443648
"219",11112,1245,2500000,0.825,250,443898
"2248",25296,83,810000,0.65,81,443979
"4132",71,-454,2360000,0.6,236,444215
"2073",27002,356,3590000,0.65,359,444574
"1530",42905,352,1360000,0.65,136,444710
"2920",34091,-236,1700000,0.6,170,444880
"2305",39251,99,640000,0.65,64,444944
"5438",1746,-738,8e+05,0.3,80,445024
"510",34015,566,1e+06,0.775,100,445124
"194",13219,1011,7e+05,0.825,70,445194
"1065",38865,737.5,3450000,0.775,345,445539
"2370",360,136,1120000,0.65,112,445651
"1194",35863,141.5,1460000,0.65,146,445797
"3269",32710,-381,490000,0.6,49,445846
"38",21349,2106,2260000,0.9,226,446072
"4738",34157,-585,8e+05,0.3,80,446152
"2601",36236,-103,1700000,0.6,170,446322
"1202",35933,312,1e+06,0.65,100,446422
"1660",31591,338,3760000,0.65,376,446798
"3690",29172,-11,1540000,0.6,154,446952
"4212",17813,-800,8e+05,0.3,80,447032
"3490",31050,-387,810000,0.6,81,447113
"2139",2786,112,7e+05,0.65,70,447183
"3703",21093,-254,1190000,0.6,119,447302
"2864",11958,-20,1500000,0.6,150,447452
"4474",36034,-911,630000,0.3,63,447515
"932",40291,604,490000,0.775,49,447564
"3817",20911,-472,640000,0.6,64,447628
"1382",33909,357,1960000,0.65,196,447824
"4186",37956,-783,3600000,0.3,360,448184
"1887",28963,220,8e+05,0.65,80,448264
"341",2236,1242,630000,0.825,63,448327
"1271",34634,104,630000,0.65,63,448390
"5133",8401,-611,720000,0.3,72,448462
"1594",32064,105,2800000,0.65,280,448742
"3047",11008,-36,3190000,0.6,319,449061
"2695",35496,-432,1260000,0.6,126,449187
"1709",31269,16,2630000,0.65,263,449450
"5378",26924,-619,560000,0.3,56,449506
"1170",36129,128,8e+05,0.65,80,449586
"3455",8277,-217,7e+05,0.6,70,449656
"927",19405,897,640000,0.775,64,449720
"1110",38099,254,640000,0.65,64,449784
"1329",34026,35.5,1700000,0.65,170,449954
"4067",39058,-344,560000,0.6,56,450010
"2192",26177,67,3060000,0.65,306,450316
"965",1938,585,1e+06,0.775,100,450416
"5031",42835,-919,1700000,0.3,170,450586
"3565",7490,-342,560000,0.6,56,450642
"350",40019,1121,7e+05,0.825,70,450712
"633",8832,881,1050000,0.775,105,450817
"5957",35647,-1490,8e+05,0.1,80,450897
"4948",10399,-632,720000,0.3,72,450969
"6506",684,-1292,1e+06,0.1,100,451069
"5351",27287,-748,1360000,0.3,136,451205
"1513",21384,487,1e+06,0.65,100,451305
"5051",32096,-858,1990000,0.3,199,451504
"4023",25020,-333,8e+05,0.6,80,451584
"1750",30348,20,1500000,0.65,150,451734
"1608",42684,19,8e+05,0.65,80,451814
"2739",23789,-133,7e+05,0.6,70,451884
"1169",36272,456,8e+05,0.65,80,451964
"1859",29545,319,2260000,0.65,226,452190
"4913",10559,-659,490000,0.3,49,452239
"2443",37769,-384.5,3830000,0.6,383,452622
"2162",26243,332,1360000,0.65,136,452758
"580",32789,510,1700000,0.775,170,452928
"3497",8371,-394,1820000,0.6,182,453110
"6288",30886,-1367,630000,0.1,63,453173
"3683",42121,-85,490000,0.6,49,453222
"868",4047,523,8e+05,0.775,80,453302
"264",42650,1297,1e+06,0.825,100,453402
"2164",2392,38,640000,0.65,64,453466
"2644",43694,-163,9e+05,0.6,90,453556
"2222",25973,126,1800000,0.65,180,453736
"1542",9992,190,640000,0.65,64,453800
"40",9441,2054,560000,0.9,56,453856
"5857",15011,-1365,7e+05,0.1,70,453926
"1461",10353,385,720000,0.65,72,453998
"2581",15289,-31,7e+05,0.6,70,454068
"4373",15769,-567,1800000,0.3,180,454248
"2649",14344,-400,1440000,0.6,144,454392
"3228",10135,-289,560000,0.6,56,454448
"108",31404,1638,3110000,0.85,311,454759
"948",2098,646,2400000,0.775,240,454999
"1745",7821,147,8e+05,0.65,80,455079
"3209",10241,-323,8e+05,0.6,80,455159
"3801",5637,-227,7430000,0.6,743,455902
"562",32906,664,560000,0.775,56,455958
"929",40418,956,8e+05,0.775,80,456038
"5466",25637,-627,640000,0.3,64,456102
"426",36666,532,1640000,0.775,164,456266
"3531",7989,-53,630000,0.6,63,456329
"3320",32350,-227,4060000,0.6,406,456735
"4940",33070,-817,2800000,0.3,280,457015
"5736",16861,-1177.5,2300000,0.1,230,457245
"6203",10447,-1189,2560000,0.1,256,457501
"915",2844,733,560000,0.775,56,457557
"3950",40315,-65,1050000,0.6,105,457662
"258",32218,1436,3690000,0.825,369,458031
"6624",17078,-1728,2260000,0.05,226,458257
"3834",41063,-252,9e+05,0.6,90,458347
"2577",36594,-222,8580000,0.6,858,459205
"1959",28349,251,7e+05,0.65,70,459275
"3901",19903,-445,4260000,0.6,426,459701
"2103",3257,418,560000,0.65,56,459757
"4099",38763,-282,1360000,0.6,136,459893
"1295",43348,11,7e+05,0.65,70,459963
"5456",25660,-627,490000,0.3,49,460012
"3354",9288,-412,1190000,0.6,119,460131
"2628",14592,-195,2150000,0.6,215,460346
"2980",33880,-341,8e+05,0.6,80,460426
"3278",32642,-21,1830000,0.6,183,460609
"2311",24267,443,8e+05,0.65,80,460689
"742",6058,577,7e+05,0.775,70,460759
"3734",28754,-308,560000,0.6,56,460815
"3057",33340,-457.333333333333,6190000,0.6,619,461434
"369",23640,1296,1700000,0.825,170,461604
"4910",10695,-871,1260000,0.3,126,461730
"1436",33239,39,1e+06,0.65,100,461830
"590",42899,860.5,6590000,0.775,659,462489
"4030",25361,-480,2890000,0.6,289,462778
"4166",18307,-766,8e+05,0.3,80,462858
"1848",6421,344,1e+06,0.65,100,462958
"208",34501,1071,4040000,0.825,404,463362
"1316",11826,65,640000,0.65,64,463426
"7010",123,-1637,560000,0.05,56,463482
"2495",37061,-118,490000,0.6,49,463531
"4840",10961,-645.5,1260000,0.3,126,463657
"3515",31178,-63,9e+05,0.6,90,463747
"914",22741,581,490000,0.775,49,463796
"5175",31168,-875,8e+05,0.3,80,463876
"3182",32958,-489,560000,0.6,56,463932
"4304",16790,-877,560000,0.3,56,463988
"1415",21464,8,3810000,0.65,381,464369
"2502",36923,-315,560000,0.6,56,464425
"6594",43983,-1810,1e+06,0.05,100,464525
"5012",32742,-933,1560000,0.3,156,464681
"4734",43328,-931,560000,0.3,56,464737
"3329",42834,-125,7e+05,0.6,70,464807
"1370",33848,180.5,1190000,0.65,119,464926
"621",9231,675,640000,0.775,64,464990
"2435",18023,-396.333333333333,4230000,0.6,423,465413
"589",32665,651,1050000,0.775,105,465518
"6363",28118,-1108,640000,0.1,64,465582
"4360",44397,-870,1e+06,0.3,100,465682
"2383",96,278,2850000,0.65,285,465967
"5832",36729,-1142,8750000,0.1,875,466842
"2461",37239,-339,1190000,0.6,119,466961
"4006",25399,-108,560000,0.6,56,467017
"3267",32726,-176.5,1290000,0.6,129,467146
"1896",6120,474,1820000,0.65,182,467328
"6299",7790,-1067,8e+05,0.1,80,467408
"3481",8650,-46,720000,0.6,72,467480
"2942",33904,-478,8e+05,0.6,80,467560
"1126",44087,84,1200000,0.65,120,467680
"4236",17549,-839,1290000,0.3,129,467809
"2080",22958,187,560000,0.65,56,467865
"2795",34768,-180,8e+05,0.6,80,467945
"2483",17184,-234,1e+06,0.6,100,468045
"77",13304,1908.66666666667,3200000,0.85,320,468365
"206",34395,1479,1e+06,0.825,100,468465
"872",40763,558,560000,0.775,56,468521
"2819",12496,-270,720000,0.6,72,468593
"2062",20295,435,8e+05,0.65,80,468673
"1214",35714,60,560000,0.65,56,468729
"1610",32020,205,1190000,0.65,119,468848
"4846",10990,-797,640000,0.3,64,468912
"1852",29585,465,5430000,0.65,543,469455
"3545",30621,-197,560000,0.6,56,469511
"1426",33206,81,1260000,0.65,126,469637
"5319",27993,-623,720000,0.3,72,469709
"1583",9238,279,7e+05,0.65,70,469779
"2255",23481,426,490000,0.65,49,469828
"402",24220,1033,1750000,0.825,175,470003
"4348",16241,-750,2680000,0.3,268,470271
"2173",26196,67,1190000,0.65,119,470390
"3105",33315,-490,7e+05,0.6,70,470460
"1645",42670,6,1360000,0.65,136,470596
"2438",17801,-431.666666666667,3520000,0.6,352,470948
"1151",36489,172,720000,0.65,72,471020
"778",28860,968,4550000,0.775,455,471475
"6956",3747,-1684,1560000,0.05,156,471631
"2119",2932,122,8e+05,0.65,80,471711
"640",42718,821.5,5090000,0.775,509,472220
"1818",29448,280.5,1600000,0.65,160,472380
"2227",40002,477,2480000,0.65,248,472628
"1915",23034,366,1360000,0.65,136,472764
"2401",38095,-405,1360000,0.6,136,472900
"3172",33009,-317,1360000,0.6,136,473036
"1831",6660,383,1e+06,0.65,100,473136
"4357",36616,-596,2860000,0.3,286,473422
"622",9170,675,560000,0.775,56,473478
"221",11071,1214,640000,0.825,64,473542
"3884",20128,-334,8e+05,0.6,80,473622
"5312",41458,-645,560000,0.3,56,473678
"88",33971,1639,5230000,0.85,523,474201
"3727",6341,-77,1680000,0.6,168,474369
"2620",14537,-455,1440000,0.6,144,474513
"2069",40749,187,8e+05,0.65,80,474593
"2831",12470,-183.5,1120000,0.6,112,474705
"884",40921,988,7e+05,0.775,70,474775
"4435",36250,-867,7e+05,0.3,70,474845
"6400",4254,-1081.5,2630000,0.1,263,475108
"3442",32001,-490,10800000,0.6,1080,476188
"408",24087,1278,2700000,0.825,270,476458
"2145",22749,410,1050000,0.65,105,476563
"462",35242,948,2310000,0.775,231,476794
"3351",9043,-412,2290000,0.6,229,477023
"3293",32646,-98,7e+05,0.6,70,477093
"4419",36360,-916,1260000,0.3,126,477219
"4843",33464,-530,2700000,0.3,270,477489
"2666",35783,-174,2260000,0.6,226,477715
"176",35881,1305,490000,0.825,49,477764
"1261",12975,243,2340000,0.65,234,477998
"1215",35698,256,630000,0.65,63,478061
"2417",37897,-499,490000,0.6,49,478110
"2135",26387,200,1260000,0.65,126,478236
"439",14886,618.5,5990000,0.775,599,478835
"3577",30570,-156,4040000,0.6,404,479239
"3383",32054,-344,1990000,0.6,199,479438
"2525",36730,-124,7e+05,0.6,70,479508
"4670",12631,-584,1990000,0.3,199,479707
"1861",29390,324,1360000,0.65,136,479843
"1581",32118,290.5,1120000,0.65,112,479955
"3582",7363,-474,7e+05,0.6,70,480025
"7004",39246,-1545,640000,0.05,64,480089
"2977",33693,-287,1190000,0.6,119,480208
"5689",17276,-1070,1890000,0.1,189,480397
"3053",10952,-293,1950000,0.6,195,480592
"2794",34962,-309,2400000,0.6,240,480832
"4314",36806,-766,1260000,0.3,126,480958
"4760",43303,-632,560000,0.3,56,481014
"5286",28466,-807,1200000,0.3,120,481134
"4241",17572,-805,1800000,0.3,180,481314
"4625",13153,-535,560000,0.3,56,481370
"3564",7463,-474,560000,0.6,56,481426
"103",8829,1588,8e+05,0.85,80,481506
"1708",8304,82,640000,0.65,64,481570
"5394",40643,-899,560000,0.3,56,481626
"491",12036,704,1e+06,0.775,100,481726
"6350",28300,-1443,560000,0.1,56,481782
"2565",43821,-475,8e+05,0.6,80,481862
"3590",30167,-259,490000,0.6,49,481911
"136",42038,1905.5,3340000,0.85,334,482245
"2400",38089,-420,7e+05,0.6,70,482315
"4029",24980,-412,1190000,0.6,119,482434
"2859",34337,-77,3060000,0.6,306,482740
"2029",40976,292,8e+05,0.65,80,482820
"1273",34648,87,1830000,0.65,183,483003
"4812",11503,-779.333333333333,7140000,0.3,714,483717
"34",10147,2012,1360000,0.9,136,483853
"3771",5841,-316,7e+05,0.6,70,483923
"1565",9796,356,490000,0.65,49,483972
"4703",34461,-539,7e+05,0.3,70,484042
"5406",26393,-916.5,1490000,0.3,149,484191
"579",10085,510,7e+05,0.775,70,484261
"4549",35507,-883,1610000,0.3,161,484422
"5191",21215,-556,3550000,0.3,355,484777
"1561",32380,317.333333333333,1890000,0.65,189,484966
"3083",33316,-236,1700000,0.6,170,485136
"1988",5249,190,8e+05,0.65,80,485216
"3775",28442,-62,560000,0.6,56,485272
"4011",25600,-348,3590000,0.6,359,485631
"6930",42064,-1559,7e+05,0.05,70,485701
"3339",32114,-150.666666666667,3640000,0.6,364,486065
"3243",10090,-232,7e+05,0.6,70,486135
"6814",11009,-1731,7e+05,0.05,70,486205
"3261",10029,-111,7e+05,0.6,70,486275
"2341",38868,23,560000,0.65,56,486331
"165",36284,1375,1500000,0.825,150,486481
"3174",42937,-317,560000,0.6,56,486537
"3205",10288,-434,1260000,0.6,126,486663
"804",21002,722,8e+05,0.775,80,486743
"6707",36184,-1947,8e+05,0.05,80,486823
"2766",34995,-253.5,1500000,0.6,150,486973
"4020",1251,-251,7e+05,0.6,70,487043
"1947",5780,7.25,4220000,0.65,422,487465
"1054",39063,848,1400000,0.775,140,487605
"2585",36386,-287,1e+06,0.6,100,487705
"4503",14127,-532.5,2960000,0.3,296,488001
"2982",33685,-319.5,2160000,0.6,216,488217
"4109",347,-312,1e+06,0.6,100,488317
"4904",10688,-916,3640000,0.3,364,488681
"271",42558,1354,1360000,0.825,136,488817
"4572",35424,-787,1700000,0.3,170,488987
"5700",17149,-1178,2720000,0.1,272,489259
"3443",8884,-416,7e+05,0.6,70,489329
"3233",10077,-205,7e+05,0.6,70,489399
"892",22989,714,490000,0.775,49,489448
"3355",32203,-412,1e+06,0.6,100,489548
"1785",42250,102,560000,0.65,56,489604
"3809",28079,-67,8e+05,0.6,80,489684
"625",8969,596,8e+05,0.775,80,489764
"2030",4633,220,9e+05,0.65,90,489854
"5324",27868,-743,640000,0.3,64,489918
"2270",39697,376,1850000,0.65,185,490103
"6555",38009,-1551,4170000,0.05,417,490520
"2655",35876,-127,1290000,0.6,129,490649
"1802",7102,367,2380000,0.65,238,490887
"2448",37474,-17,2090000,0.6,209,491096
"1871",29611,479.333333333333,8730000,0.65,873,491969
"1193",35944,156.5,1050000,0.65,105,492074
"4164",38091,-510,5090000,0.3,509,492583
"2390",38317,-13,560000,0.6,56,492639
"1455",42941,222,2060000,0.65,206,492845
"5052",9156,-590.5,2260000,0.3,226,493071
"3686",29189,-421.5,1260000,0.6,126,493197
"6073",34383,-1281,1050000,0.1,105,493302
"213",11563,1131,2260000,0.825,226,493528
"4170",18140,-894,1e+06,0.3,100,493628
"1023",25109,968,1360000,0.775,136,493764
"1851",29271,41,9e+05,0.65,90,493854
"3390",8900,-184,9e+05,0.6,90,493944
"1678",8442,31,8e+05,0.65,80,494024
"305",41950,1002,3550000,0.825,355,494379
"4991",10124,-682,7e+05,0.3,70,494449
"1450",33077,387,1440000,0.65,144,494593
"4446",36143,-611,7e+05,0.3,70,494663
"5604",37867,-1152.5,1050000,0.1,105,494768
"3756",41766,-500,560000,0.6,56,494824
"1175",14792,456,1890000,0.65,189,495013
"3125",10522,-373,7e+05,0.6,70,495083
"2936",11846,-109,7e+05,0.6,70,495153
"4976",10172,-546,1050000,0.3,105,495258
"1624",8935,11,1340000,0.65,134,495392
"5181",8050,-501,640000,0.3,64,495456
"3699",42133,-231,1610000,0.6,161,495617
"1531",44296,309,490000,0.65,49,495666
"6161",10519,-1242,490000,0.1,49,495715
"4358",36701,-612,1560000,0.3,156,495871
"3501",8069,-430,640000,0.6,64,495935
"5985",13618,-1375,2550000,0.1,255,496190
"2536",15966,-317.75,2960000,0.6,296,496486
"1567",9645,219,7e+05,0.65,70,496556
"877",40733,722,7e+05,0.775,70,496626
"4337",36689,-820,490000,0.3,49,496675
"3999",1659,-288,1360000,0.6,136,496811
"1833",29769,174,1700000,0.65,170,496981
"2809",12943,-448,3090000,0.6,309,497290
"1973",28305,151,1500000,0.65,150,497440
"2650",14422,-134,640000,0.6,64,497504
"4296",16785,-668,1e+06,0.3,100,497604
"2151",2812,332,1500000,0.65,150,497754
"95",10000,1585,1050000,0.85,105,497859
"2391",18700,-13,490000,0.6,49,497908
"2818",12633,-406,1190000,0.6,119,498027
"5711",17169,-1429,2400000,0.1,240,498267
"3395",8782,-69,8e+05,0.6,80,498347
"5730",36908,-1206,1290000,0.1,129,498476
"4789",11517,-850,1400000,0.3,140,498616
"1701",30952,52,630000,0.65,63,498679
"826",41322,814,640000,0.775,64,498743
"5449",25608,-635,560000,0.3,56,498799
"4661",34750,-616.5,1360000,0.3,136,498935
"493",34302,756,560000,0.775,56,498991
"1017",1430,684,560000,0.775,56,499047
"5026",32295,-522,8e+05,0.3,80,499127
"3426",31735,-160,1890000,0.6,189,499316
"1813",6746,367,8e+05,0.65,80,499396
"6058",12164,-1065,490000,0.1,49,499445
"5220",29752,-964,8e+05,0.3,80,499525
"745",6045,551,1360000,0.775,136,499661
"2696",13725,-189,490000,0.6,49,499710
"4218",17869,-991,720000,0.3,72,499782
"1307",34418,454.5,10320000,0.65,1032,500814
"3296",9784,-413.5,1700000,0.6,170,500984
"2491",17269,-217,560000,0.6,56,501040
"1389",43141,60,1800000,0.65,180,501220
"1744",7664,329,640000,0.65,64,501284
"3232",32902,-132,1360000,0.6,136,501420
"2201",1991,10,8e+05,0.65,80,501500
"2515",16653,-442.5,1260000,0.6,126,501626
"1938",41907,481.5,4600000,0.65,460,502086
"3135",33183,-16,7e+05,0.6,70,502156
"1125",37660,60,1900000,0.65,190,502346
"2412",37844,-289,1560000,0.6,156,502502
"4105",38797,-112,490000,0.6,49,502551
"1015",39725,778,560000,0.775,56,502607
"2307",39131,260,1e+06,0.65,100,502707
"397",576,1187,1490000,0.825,149,502856
"3825",41434,-235,490000,0.6,49,502905
"1602",32181,71,4230000,0.65,423,503328
"3638",29438,-9,1890000,0.6,189,503517
"1212",14091,20,1890000,0.65,189,503706
"593",32669,935,8e+05,0.775,80,503786
"3580",7598,-168,8e+05,0.6,80,503866
"1725",42538,452,10900000,0.65,1090,504956
"3033",21461,-220,640000,0.6,64,505020
"3932",26281,-130,6040000,0.6,604,505624
"2888",34197,-172,640000,0.6,64,505688
"3457",31142,-96,490000,0.6,49,505737
"4073",38923,-335,7e+05,0.6,70,505807
"5868",14744,-1058,490000,0.1,49,505856
"5146",30946,-611,810000,0.3,81,505937
"5885",36209,-1376,1050000,0.1,105,506042
"3847",40992,-490,7100000,0.6,710,506752
"3689",42129,-280,1490000,0.6,149,506901
"2588",36445,-222,1400000,0.6,140,507041
"4461",36091,-517,560000,0.3,56,507097
"4363",36700,-847,8e+05,0.3,80,507177
"2168",40416,192,1440000,0.65,144,507321
"3669",29554,-383.5,12080000,0.6,1208,508529
"3344",32069,-173,1400000,0.6,140,508669
"6260",31297,-1289,560000,0.1,56,508725
"2995",11287,-128,7e+05,0.6,70,508795
"321",4442,1091,490000,0.825,49,508844
"2759",13168,-142,490000,0.6,49,508893
"1850",42161,400,8e+05,0.65,80,508973
"6146",10936,-1357,3400000,0.1,340,509313
"3161",33006,-243,2270000,0.6,227,509540
"5725",36929,-1035.66666666667,3090000,0.1,309,509849
"5413",19243,-821,8e+05,0.3,80,509929
"229",10471,1410,8e+05,0.825,80,510009
"513",11900,692,1e+06,0.775,100,510109
"2116",26424,477,9e+05,0.65,90,510199
"845",40968,574,1e+06,0.775,100,510299
"132",5659,1597,640000,0.85,64,510363
"4853",33653,-778,560000,0.3,56,510419
"4901",33255,-733,560000,0.3,56,510475
"5461",25482,-678,1440000,0.3,144,510619
"2195",40120,465.5,2200000,0.65,220,510839
"1481",32966,401,1900000,0.65,190,511029
"2664",14321,-316,2060000,0.6,206,511235
"2441",37539,-275,1200000,0.6,120,511355
"295",29193,1055,560000,0.825,56,511411
"352",25893,1315,7e+05,0.825,70,511481
"2026",27477,460,7e+05,0.65,70,511551
"4973",33021,-546,4610000,0.3,461,512012
"968",1861,666,1e+06,0.775,100,512112
"3925",22709,-123,640000,0.6,64,512176
"3346",9221,-114,1960000,0.6,196,512372
"3409",9002,-96,1360000,0.6,136,512508
"3939",2549,-22,2140000,0.6,214,512722
"1918",42058,392,2400000,0.65,240,512962
"1817",6706,286,560000,0.65,56,513018
"4145",38187,-652,1890000,0.3,189,513207
"169",14573,1058,2820000,0.825,282,513489
"1929",6596,250,4900000,0.65,490,513979
"5761",16482,-1099,8e+05,0.1,80,514059
"2023",40951,398,7e+05,0.65,70,514129
"429",44413,655,1e+06,0.775,100,514229
"2121",26413,9,1130000,0.65,113,514342
"343",2242,1129,490000,0.825,49,514391
"2449",18026,-438,3470000,0.6,347,514738
"2956",33850,-118,7e+05,0.6,70,514808
"1177",36107,388,4710000,0.65,471,515279
"581",10062,707,1360000,0.775,136,515415
"863",4351,749,8e+05,0.775,80,515495
"1467",32973,401,560000,0.65,56,515551
"3062",10691,-218,560000,0.6,56,515607
"4021",39730,-379,490000,0.6,49,515656
"2346",24172,43,560000,0.65,56,515712
"4119",233,-314,560000,0.6,56,515768
"3529",7889,-415.5,1350000,0.6,135,515903
"2935",11556,-80.6666666666667,2680000,0.6,268,516171
"4915",10612,-580.666666666667,3420000,0.3,342,516513
"4101",38723,-469,490000,0.6,49,516562
"6725",35992,-1727,490000,0.05,49,516611
"5546",38607,-508,9e+05,0.3,90,516701
"5462",25506,-717,560000,0.3,56,516757
"3993",25869,-496,560000,0.6,56,516813
"236",32961,1279,8410000,0.825,841,517654
"4070",592,-409,7e+05,0.6,70,517724
"2352",24150,219,8e+05,0.65,80,517804
"267",21380,1475,1780000,0.825,178,517982
"1880",6306,37,1750000,0.65,175,518157
"285",30078,1377,7e+05,0.825,70,518227
"3866",26938,-87,560000,0.6,56,518283
"6813",10970,-1925,1e+06,0.05,100,518383
"732",6629,551,8e+05,0.775,80,518463
"983",25886,559,490000,0.775,49,518512
"2875",11936,-243,8220000,0.6,822,519334
"2706",13798,-407.333333333333,2190000,0.6,219,519553
"3790",5320,-25.3333333333333,2200000,0.6,220,519773
"1764",7389,155,4540000,0.65,454,520227
"2197",40123,196,7e+05,0.65,70,520297
"744",44283,565,4600000,0.775,460,520757
"4079",24202,-398,490000,0.6,49,520806
"3578",30416,-79,2260000,0.6,226,521032
"3496",42467,-63,2e+06,0.6,200,521232
"3382",32058,-157,4570000,0.6,457,521689
"1417",21425,60,560000,0.65,56,521745
"71",35684,1881.5,3290000,0.85,329,522074
"2806",34730,-236,8e+05,0.6,80,522154
"3189",10189,-207,560000,0.6,56,522210
"2507",16742,-102,1960000,0.6,196,522406
"2216",25985,357,1190000,0.65,119,522525
"3710",6263,-277,1700000,0.6,170,522695
"4618",13488,-987,560000,0.3,56,522751
"6899",31051,-1500.33333333333,4420000,0.05,442,523193
"5532",230,-641,7e+05,0.3,70,523263
"1324",34109,4,9e+05,0.65,90,523353
"2613",36225,-403,1750000,0.6,175,523528
"1294",12082,11,8e+05,0.65,80,523608
"2928",43296,-376,2890000,0.6,289,523897
"6434",26328,-1203,7e+05,0.1,70,523967
"6048",12343,-1116,1200000,0.1,120,524087
"5006",32782,-926.5,1260000,0.3,126,524213
"851",4432,590,560000,0.775,56,524269
"1633",9099,71,7e+05,0.65,70,524339
"5539",212,-920,8e+05,0.3,80,524419
"5283",41737,-739,1260000,0.3,126,524545
"3301",9571,-465,1120000,0.6,112,524657
"3797",41862,-463,8500000,0.6,850,525507
"3542",7696,-269,640000,0.6,64,525571
"667",30441,993,640000,0.775,64,525635
"2071",26798,175,7e+05,0.65,70,525705
"3552",30484,-225.5,1120000,0.6,112,525817
"196",35116,1383,4390000,0.825,439,526256
"1878",29057,192,490000,0.65,49,526305
"374",23573,1243,4450000,0.825,445,526750
"2523",16212,-222.333333333333,6600000,0.6,660,527410
"2389",38323,-13,1530000,0.6,153,527563
"1680",31763,263,4970000,0.65,497,528060
"5164",8193,-758,630000,0.3,63,528123
"2658",35930,-275,1260000,0.6,126,528249
"5844",15230,-1016,1050000,0.1,105,528354
"1305",34254,65,560000,0.65,56,528410
"3709",29006,-450,8e+05,0.6,80,528490
"1688",8243,31,9e+05,0.65,90,528580
"3748",6038,-328,560000,0.6,56,528636
"6638",16748,-1553,1360000,0.05,136,528772
"681",29736,979,2200000,0.775,220,528992
"4465",44349,-701,560000,0.3,56,529048
"4647",34920,-625,4650000,0.3,465,529513
"777",6049,943.5,1800000,0.775,180,529693
"3606",21177,-355,1e+06,0.6,100,529793
"2258",39720,59,7e+05,0.65,70,529863
"1691",31415,332,4470000,0.65,447,530310
"3795",42063,-303,7250000,0.6,725,531035
"6361",41342,-1434,630000,0.1,63,531098
"5646",17635,-1124,560000,0.1,56,531154
"3507",8003,-413,8e+05,0.6,80,531234
"6044",12313,-1129,640000,0.1,64,531298
"51",42085,2254,4620000,0.9,462,531760
"4177",37708,-620,560000,0.3,56,531816
"3761",28777,-418,7e+05,0.6,70,531886
"3804",28210,-200,720000,0.6,72,531958
"4519",13976,-540,560000,0.3,56,532014
"4475",35977,-510,2810000,0.3,281,532295
"5836",44379,-1198,640000,0.1,64,532359
"142",1819,1990,2190000,0.85,219,532578
"688",6914,729,490000,0.775,49,532627
"1120",18200,60,8e+05,0.65,80,532707
"5796",16157,-1179,2190000,0.1,219,532926
"6190",33235,-1086,1260000,0.1,126,533052
"2",43637,3258,1050000,0.95,105,533157
"3546",30624,-438,8e+05,0.6,80,533237
"110",31239,1679.5,2970000,0.85,297,533534
"1204",14087,232,8e+05,0.65,80,533614
"2366",24083,292,2060000,0.65,206,533820
"2000",28070,309,720000,0.65,72,533892
"3769",5778,-349,1e+06,0.6,100,533992
"1050",24276,552,560000,0.775,56,534048
"3034",10981,-233,1360000,0.6,136,534184
"4655",12577,-747,1830000,0.3,183,534367
"6477",23555,-1112,640000,0.1,64,534431
"3994",1710,-13,490000,0.6,49,534480
"750",28900,801,2500000,0.775,250,534730
"483",13051,794.333333333333,1840000,0.775,184,534914
"2775",43521,-142,490000,0.6,49,534963
"6772",13192,-1900,1190000,0.05,119,535082
"4800",11575,-835,4300000,0.3,430,535512
"135",28120,1597,1190000,0.85,119,535631
"4078",520,-118,490000,0.6,49,535680
"5089",8774,-506,1400000,0.3,140,535820
"4225",17835,-519,2160000,0.3,216,536036
"354",25815,1315,1190000,0.825,119,536155
"4013",1358,-182,630000,0.6,63,536218
"4857",11310,-882,8890000,0.3,889,537107
"6805",11145,-1556,7e+05,0.05,70,537177
"2832",12531,-199,1990000,0.6,199,537376
"3903",26485,-215,2890000,0.6,289,537665
"5398",26687,-509,8500000,0.3,850,538515
"3836",4925,-199,7e+05,0.6,70,538585
"158",24159,1586,8e+05,0.85,80,538665
"357",25867,1114,7e+05,0.825,70,538735
"3300",42890,-425,2890000,0.6,289,539024
"4765",34093,-887,720000,0.3,72,539096
"1808",6891,444,1830000,0.65,183,539279
"2820",34714,-270,2330000,0.6,233,539512
"1456",10380,206.5,2860000,0.65,286,539798
"2689",13860,-159,7e+05,0.6,70,539868
"835",27915,602.5,3160000,0.775,316,540184
"2492",17051,-234,7e+05,0.6,70,540254
"2909",34276,-16,630000,0.6,63,540317
"1734",30819,131.5,3690000,0.65,369,540686
"368",23656,1296,1990000,0.825,199,540885
"3295",9877,-413.5,1600000,0.6,160,541045
"1448",10395,447,1360000,0.65,136,541181
"700",42186,509,7e+05,0.775,70,541251
"6083",11777,-1044,9e+05,0.1,90,541341
"4963",32962,-794.5,1750000,0.3,175,541516
"1265",12689,220.333333333333,1950000,0.65,195,541711
"145",24834,1674,7e+05,0.85,70,541781
"3330",42818,-119,1190000,0.6,119,541900
"2043",41146,446,6440000,0.65,644,542544
"3160",33106,-200,630000,0.6,63,542607
"2196",40129,382,1e+06,0.65,100,542707
"1356",33957,14,630000,0.65,63,542770
"4439",36211,-714.5,1340000,0.3,134,542904
"2422",37721,-220,7e+05,0.6,70,542974
"4143",18914,-659,2550000,0.3,255,543229
"5529",23983,-932,490000,0.3,49,543278
"503",34101,893,720000,0.775,72,543350
"641",31782,718,5590000,0.775,559,543909
"3066",10938,-374,1990000,0.6,199,544108
"2721",35367,-478,7e+05,0.6,70,544178
"4049",39376,-23,720000,0.6,72,544250
"3290",9628,-481.5,2170000,0.6,217,544467
"3759",28790,-349,7e+05,0.6,70,544537
"5258",6044,-802,7e+05,0.3,70,544607
"678",21183,670,1e+06,0.775,100,544707
"3134",33203,-13,1500000,0.6,150,544857
"995",25880,672,9e+05,0.775,90,544947
"1752",30868,444,2e+06,0.65,200,545147
"4389",36478,-716,1990000,0.3,199,545346
"6494",24719,-1396,1e+06,0.1,100,545446
"37",21365,2136,6730000,0.9,673,546119
"3094",10745,-380,490000,0.6,49,546168
"6423",26458,-1319,8e+05,0.1,80,546248
"2789",43498,-355,7e+05,0.6,70,546318
"17",25962,2703,2060000,0.925,206,546524
"1933",42034,12,8e+05,0.65,80,546604
"5473",1292,-592.166666666667,4990000,0.3,499,547103
"1679",31700,79,2140000,0.65,214,547317
"2700",35741,-66,4500000,0.6,450,547767
"5104",8583,-608,7e+05,0.3,70,547837
"3584",30219,-269,7e+05,0.6,70,547907
"2573",15143,-380,1260000,0.6,126,548033
"1264",12780,290,640000,0.65,64,548097
"2930",11722,-338.8,8530000,0.6,853,548950
"2315",735,99,3300000,0.65,330,549280
"5442",25788,-530,8e+05,0.3,80,549360
"784",41709,794,7e+05,0.775,70,549430
"5002",10099,-573,2890000,0.3,289,549719
"4129",38524,-62,2500000,0.6,250,549969
"5475",39837,-671,4750000,0.3,475,550444
"2107",26572,489,8e+05,0.65,80,550524
"1516",32738,1,1e+06,0.65,100,550624
"1773",21189,292,1850000,0.65,185,550809
"3970",26070,-51,8e+05,0.6,80,550889
"4529",14056,-832,1960000,0.3,196,551085
"5642",37376,-1344,1190000,0.1,119,551204
"828",28041,959,8e+05,0.775,80,551284
"348",1946,1299,8e+05,0.825,80,551364
"4837",11180,-778,3e+06,0.3,300,551664
"4560",13776,-617,3440000,0.3,344,552008
"2608",43739,-199,490000,0.6,49,552057
"2868",34421,-447.666666666667,1830000,0.6,183,552240
"1607",32098,303.5,2360000,0.65,236,552476
"35",21390,2224,1750000,0.9,175,552651
"5555",68,-654,7e+05,0.3,70,552721
"3030",33499,-36,560000,0.6,56,552777
"2300",39208,440,560000,0.65,56,552833
"1636",31873,37.5,4360000,0.65,436,553269
"4428",15069,-852.666666666667,2260000,0.3,226,553495
"6551",18246,-1962,1700000,0.05,170,553665
"2725",13468,-133,1560000,0.6,156,553821
"4849",11084,-934,640000,0.3,64,553885
"1343",34078,395,4650000,0.65,465,554350
"5073",8863,-882,8e+05,0.3,80,554430
"4688",34651,-794,3270000,0.3,327,554757
"4400",36469,-762,640000,0.3,64,554821
"4217",37503,-966.5,1830000,0.3,183,555004
"4287",16943,-774,2040000,0.3,204,555208
"584",10078,644,2e+06,0.775,200,555408
"3713",42090,-412,7e+05,0.6,70,555478
"6204",10311,-1293,1700000,0.1,170,555648
"4680",34715,-949,6750000,0.3,675,556323
"823",41249,682,630000,0.775,63,556386
"5504",836,-596,1700000,0.3,170,556556
"4573",13701,-740.5,4300000,0.3,430,556986
"3906",2947,-217,1190000,0.6,119,557105
"3154",42943,-14,630000,0.6,63,557168
"5285",5688,-532,3050000,0.3,305,557473
"2634",14453,-385,9e+05,0.6,90,557563
"471",13316,627,490000,0.775,49,557612
"1379",11568,26,2820000,0.65,282,557894
"433",36205,612,1050000,0.775,105,557999
"450",35634,938,1360000,0.775,136,558135
"366",39975,1094,2550000,0.825,255,558390
"5069",31658,-975,490000,0.3,49,558439
"5649",17615,-1013.5,1920000,0.1,192,558631
"3716",28996,-308,3450000,0.6,345,558976
"627",9086,718,7e+05,0.775,70,559046
"3653",29435,-259,8e+05,0.6,80,559126
"2403",38073,-143,640000,0.6,64,559190
"6482",23501,-1112,7e+05,0.1,70,559260
"1627",21328,34,1200000,0.65,120,559380
"6263",31370,-1159,7e+05,0.1,70,559450
"6419",26522,-1254,8e+05,0.1,80,559530
"5222",29645,-582,1640000,0.3,164,559694
"4548",13816,-813,1340000,0.3,134,559828
"1739",30953,233,3450000,0.65,345,560173
"2415",37805,-139,490000,0.6,49,560222
"5444",25703,-568,1e+06,0.3,100,560322
"2253",25158,415,560000,0.65,56,560378
"1092",23930,650,490000,0.775,49,560427
"1242",35425,50,1800000,0.65,180,560607
"4658",34785,-570,640000,0.3,64,560671
"4767",34058,-613.5,1360000,0.3,136,560807
"1827",7000,260,8e+05,0.65,80,560887
"3095",33286,-269,1850000,0.6,185,561072
"3889",26578,-311,7e+05,0.6,70,561142
"1026",39666,854,7e+05,0.775,70,561212
"1906",29113,278.5,3180000,0.65,318,561530
"1796",30093,324,2500000,0.65,250,561780
"5256",6129,-556,1560000,0.3,156,561936
"1720",31010,21,9e+05,0.65,90,562026
"6858",32474,-1968,1260000,0.05,126,562152
"3877",20153,-144,1260000,0.6,126,562278
"813",5401,571.666666666667,2310000,0.775,231,562509
"3676",42170,-35,490000,0.6,49,562558
"5370",40852,-908,5890000,0.3,589,563147
"3334",32175,-180,3960000,0.6,396,563543
"975",40117,958,3250000,0.775,325,563868
"4230",17610,-842,8e+05,0.3,80,563948
"1893",6700,85.6666666666667,2060000,0.65,206,564154
"771",5759,545,1400000,0.775,140,564294
"6074",11852,-1387,1440000,0.1,144,564438
"1721",30963,27,4120000,0.65,412,564850
"1584",32136,351.5,1760000,0.65,176,565026
"2144",2764,410,7e+05,0.65,70,565096
"1027",24871,945,560000,0.775,56,565152
"1892",28977,367.333333333333,4490000,0.65,449,565601
"5032",42831,-773,490000,0.3,49,565650
"4744",11819,-994,560000,0.3,56,565706
"1412",10973,66.5,1700000,0.65,170,565876
"1310",11830,453,1280000,0.65,128,566004
"6180",33238,-1321,1700000,0.1,170,566174
"1245",35357,132,560000,0.65,56,566230
"514",11495,919,1290000,0.775,129,566359
"6041",23751,-1060,9e+05,0.1,90,566449
"722",29070,577,1190000,0.775,119,566568
"1792",7610,387,490000,0.65,49,566617
"617",9188,699,1500000,0.775,150,566767
"1256",35314,168,4810000,0.65,481,567248
"5864",43771,-1251.66666666667,1750000,0.1,175,567423
"2423",37728,-393,490000,0.6,49,567472
"1716",30917,157,1190000,0.65,119,567591
"3439",8580,-471,490000,0.6,49,567640
"4115",23980,-76,2200000,0.6,220,567860
"6262",31267,-1376,560000,0.1,56,567916
"1612",9233,205,8e+05,0.65,80,567996
"1894",21079,332.5,1400000,0.65,140,568136
"1731",30632,237,720000,0.65,72,568208
"3273",10051,-268,2650000,0.6,265,568473
"5274",28867,-923,640000,0.3,64,568537
"4709",12282,-792,9e+05,0.3,90,568627
"5514",24236,-908,2060000,0.3,206,568833
"3038",33546,-405,640000,0.6,64,568897
"6779",12739,-1869,7e+05,0.05,70,568967
"4715",43342,-687,1e+06,0.3,100,569067
"2784",35058,-128,1360000,0.6,136,569203
"4870",33344,-635.5,2500000,0.3,250,569453
"3372",32135,-190,7660000,0.6,766,570219
"2101",19962,57,1260000,0.65,126,570345
"3321",9510,-312.333333333333,2760000,0.6,276,570621
"2277",916,171,1120000,0.65,112,570733
"3613",7125,-172.25,2860000,0.6,286,571019
"2037",4459,292,560000,0.65,56,571075
"275",31652,1241,2060000,0.825,206,571281
"4039",39607,-328,1500000,0.6,150,571431
"3530",30773,-256,9e+05,0.6,90,571521
"5064",31707,-560,7e+05,0.3,70,571591
"4595",43597,-542,2450000,0.3,245,571836
"880",26811,838,490000,0.775,49,571885
"6240",9180,-1013.5,3060000,0.1,306,572191
"840",5046,833,560000,0.775,56,572247
"2404",37967,-420,560000,0.6,56,572303
"661",42515,592,6100000,0.775,610,572913
"2924",11686,-286,1700000,0.6,170,573083
"4770",11626,-835,1500000,0.3,150,573233
"2902",34117,-236,1350000,0.6,135,573368
"676",7095,913,7e+05,0.775,70,573438
"1425",33174,147,560000,0.65,56,573494
"3725",29074,-236,1850000,0.6,185,573679
"1921",28847,407,7e+05,0.65,70,573749
"6447",40219,-1148,7e+05,0.1,70,573819
"698",21161,601,1260000,0.775,126,573945
"3018",11081,-351,1e+06,0.6,100,574045
"4110",23985,-500,1e+06,0.6,100,574145
"815",5369,638,1460000,0.775,146,574291
"2979",33830,-392,1190000,0.6,119,574410
"6859",32363,-1968,8e+05,0.05,80,574490
"1719",8455,225,640000,0.65,64,574554
"415",188,1017,630000,0.825,63,574617
"3215",10128,-84.6666666666667,2850000,0.6,285,574902
"1388",11318,312,1600000,0.65,160,575062
"4330",36757,-672,7e+05,0.3,70,575132
"3915",22772,-114,1700000,0.6,170,575302
"4512",14316,-634,2550000,0.3,255,575557
"4282",16997,-968.5,1290000,0.3,129,575686
"4376",44395,-870,1440000,0.3,144,575830
"6071",11921,-1032,2720000,0.1,272,576102
"2633",35949,-379,2080000,0.6,208,576310
"4485",35974,-964,560000,0.3,56,576366
"3118",10531,-333,1260000,0.6,126,576492
"1449",33162,157,560000,0.65,56,576548
"2112",26456,470,630000,0.65,63,576611
"4080",24157,-235.5,2260000,0.6,226,576837
"4797",11491,-855.666666666667,6e+06,0.3,600,577437
"5372",4062,-635,7e+05,0.3,70,577507
"4533",35726,-1000,2860000,0.3,286,577793
"4527",14015,-592,8e+05,0.3,80,577873
"2410",37870,-67.5,1560000,0.6,156,578029
"3487",31089,-339,1700000,0.6,170,578199
"4317",36826,-995,7e+05,0.3,70,578269
"1016",39758,778,1190000,0.775,119,578388
"5401",26411,-916.5,2530000,0.3,253,578641
"78",34908,1697,8e+05,0.85,80,578721
"4484",35916,-797.5,1050000,0.3,105,578826
"1143",36698,402,3080000,0.65,308,579134
"5159",8146,-588,1920000,0.3,192,579326
"3646",30566,-323,13480000,0.6,1348,580674
"63",24881,2476,3540000,0.9,354,581028
"1460",33039,157,630000,0.65,63,581091
"1853",29316,300,7e+05,0.65,70,581161
"4998",10146,-818,560000,0.3,56,581217
"4902",10643,-733,7e+05,0.3,70,581287
"4737",12017,-503,1360000,0.3,136,581423
"1897",6102,466,1190000,0.65,119,581542
"4117",256,-314,1680000,0.6,168,581710
"4662",35086,-585,8040000,0.3,804,582514
"4828",33798,-911,1560000,0.3,156,582670
"4887",10719,-525,490000,0.3,49,582719
"3025",10929,-433.333333333333,3380000,0.6,338,583057
"2926",11633,-242.333333333333,2200000,0.6,220,583277
"1326",34251,10,7990000,0.65,799,584076
"3618",29858,-160,1800000,0.6,180,584256
"3880",40690,-411.666666666667,4740000,0.6,474,584730
"1199",35871,212,1e+06,0.65,100,584830
"3173",33010,-317,640000,0.6,64,584894
"113",30829,1881,490000,0.85,49,584943
"532",21475,915.5,1360000,0.775,136,585079
"2434",37768,-384.5,1390000,0.6,139,585218
"4850",10909,-744,1360000,0.3,136,585354
"4229",17616,-647,720000,0.3,72,585426
"5201",30080,-688.5,1260000,0.3,126,585552
"5502",39501,-578,1530000,0.3,153,585705
"630",31637,673,7e+05,0.775,70,585775
"2098",3249,418,1500000,0.65,150,585925
"319",40935,1091,8e+05,0.825,80,586005
"4790",11414,-685.25,5010000,0.3,501,586506
"3",43610,3258,3260000,0.95,326,586832
"899",3118,555,1360000,0.775,136,586968
"3268",10056,-77,490000,0.6,49,587017
"2426",37829,-443,7e+05,0.6,70,587087
"214",33914,1223,3550000,0.825,355,587442
"4815",11173,-662.5,2410000,0.3,241,587683
"1991",41600,101,560000,0.65,56,587739
"6320",6510,-1067,2360000,0.1,236,587975
"284",30090,1377,560000,0.825,56,588031
"22",35658,2135,630000,0.9,63,588094
"3129",10591,-380,2850000,0.6,285,588379
"5522",24102,-768,8e+05,0.3,80,588459
"3985",25951,-288,560000,0.6,56,588515
"1139",16850,65,7e+05,0.65,70,588585
"1775",29954,372,1500000,0.65,150,588735
"6895",31365,-1688,2060000,0.05,206,588941
"454",43618,574,1200000,0.775,120,589061
"2282",24460,124,3830000,0.65,383,589444
"6304",7655,-1040,7e+05,0.1,70,589514
"821",28066,587,630000,0.775,63,589577
"45",30967,2002,9e+05,0.9,90,589667
"4065",39092,-351,1820000,0.6,182,589849
"6298",30424,-1067,7e+05,0.1,70,589919
"3449",8280,-450,560000,0.6,56,589975
"2532",36654,-24,1700000,0.6,170,590145
"1738",30791,498,1990000,0.65,199,590344
"1541",9937,358,640000,0.65,64,590408
"1857",6473,43,490000,0.65,49,590457
"6918",29261,-1937,2450000,0.05,245,590702
"2428",44112,-321,1700000,0.6,170,590872
"1599",9060,231,7e+05,0.65,70,590942
"3952",26204,-458,4250000,0.6,425,591367
"4391",43830,-941,720000,0.3,72,591439
"997",1539,513,8e+05,0.775,80,591519
"602",32537,566,2550000,0.775,255,591774
"2834",43455,-359,8e+05,0.6,80,591854
"4197",37542,-570,7e+05,0.3,70,591924
"2259",39734,42,2400000,0.65,240,592164
"6036",34819,-1226,8e+05,0.1,80,592244
"3704",6221,-30,2e+06,0.6,200,592444
"4275",17153,-648,2580000,0.3,258,592702
"699",21139,732,2140000,0.775,214,592916
"2591",14969,-440,560000,0.6,56,592972
"1533",42870,388,640000,0.65,64,593036
"3336",9313,-384,490000,0.6,49,593085
"4308",36872,-784,490000,0.3,49,593134
"5039",32530,-552,2550000,0.3,255,593389
"32",10108,2012,490000,0.9,49,593438
"3729",42043,-54,490000,0.6,49,593487
"241",21374,1162,490000,0.825,49,593536
"257",9525,1243,8e+05,0.825,80,593616
"2063",26907,101,490000,0.65,49,593665
"4369",15570,-901.5,1360000,0.3,136,593801
"3867",26977,-87,490000,0.6,49,593850
"3583",30287,-474,8e+05,0.6,80,593930
"432",15156,787,8e+05,0.775,80,594010
"1192",14303,158,1050000,0.65,105,594115
"1049",39108,517,560000,0.775,56,594171
"5257",42055,-697,560000,0.3,56,594227
"155",39677,1834,1460000,0.85,146,594373
"6513",505,-1275,8e+05,0.1,80,594453
"178",13972,1033,8e+05,0.825,80,594533
"5103",31287,-608,1e+06,0.3,100,594633
"1030",1007,873,8e+05,0.775,80,594713
"3768",28946,-328,5300000,0.6,530,595243
"2371",342,316,560000,0.65,56,595299
"2915",11762,-207,1720000,0.6,172,595471
"5246",6356,-554.5,1190000,0.3,119,595590
"1260",12891,239,8e+05,0.65,80,595670
"963",19026,740,7e+05,0.775,70,595740
"3701",6176,-336,1360000,0.6,136,595876
"1568",9996,309,1700000,0.65,170,596046
"908",2903,686,2500000,0.775,250,596296
"2039",27582,457,8200000,0.65,820,597116
"3829",41203,-163,8e+05,0.6,80,597196
"2569",36455,-422.5,1260000,0.6,126,597322
"445",14277,788.666666666667,2680000,0.775,268,597590
"3402",8685,-311,1e+06,0.6,100,597690
"6153",10926,-1080,4550000,0.1,455,598145
"4839",11100,-655,2500000,0.3,250,598395
"4169",18350,-800.5,1800000,0.3,180,598575
"3375",31917,-186,2440000,0.6,244,598819
"89",21419,1639,7e+05,0.85,70,598889
"974",40145,587,4750000,0.775,475,599364
"1748",30501,136,1830000,0.65,183,599547
"3863",40780,-472,490000,0.6,49,599596
"5176",30813,-875,640000,0.3,64,599660
"618",9168,717,8e+05,0.775,80,599740
"3942",26292,-251,8770000,0.6,877,600617
"4825",33569,-710,560000,0.3,56,600673
"1819",42200,233,8e+05,0.65,80,600753
"1421",43165,301,9700000,0.65,970,601723
"2085",26760,253,560000,0.65,56,601779
"536",33562,831,2060000,0.775,206,601985
"4949",32960,-683.5,2730000,0.3,273,602258
"4089",379,-282,7e+05,0.6,70,602328
"64",24548,2268,2250000,0.9,225,602553
"3521",7936,-442,630000,0.6,63,602616
"1955",28524,22,8e+05,0.65,80,602696
"1596",32024,240,1540000,0.65,154,602850
"3600",30230,-168,2890000,0.6,289,603139
"6675",15198,-1870,1700000,0.05,170,603309
"2120",3004,122,560000,0.65,56,603365
"1482",10261,270,1200000,0.65,120,603485
"4711",12265,-798,1360000,0.3,136,603621
"2966",33992,-227,1680000,0.6,168,603789
"6287",42400,-1055,2890000,0.1,289,604078
"4996",32936,-847,4320000,0.3,432,604510
"1298",11934,259,1190000,0.65,119,604629
"3178",33244,-33,3850000,0.6,385,605014
"5850",15185,-1064,2060000,0.1,206,605220
"4093",38791,-108,2440000,0.6,244,605464
"1010",25168,776,3050000,0.775,305,605769
"4178",37993,-652,5370000,0.3,537,606306
"3752",5727,-425,1850000,0.6,185,606491
"1479",42922,263.5,2620000,0.65,262,606753
"1545",32534,209,1340000,0.65,134,606887
"1509",32794,85,1050000,0.65,105,606992
"4899",42975,-788,1050000,0.3,105,607097
"263",8819,1085,1750000,0.825,175,607272
"5268",28670,-532,2500000,0.3,250,607522
"469",35206,720.5,2360000,0.775,236,607758
"280",30533,1157,3310000,0.825,331,608089
"73",35521,1785.5,4e+06,0.85,400,608489
"6911",30491,-1861,1e+06,0.05,100,608589
"2358",24119,23,1900000,0.65,190,608779
"3815",20943,-316,560000,0.6,56,608835
"5309",28133,-909,640000,0.3,64,608899
"3031",11059,-36,560000,0.6,56,608955
"2021",4622,165,1920000,0.65,192,609147
"4530",13968,-686.5,5580000,0.3,558,609705
"3518",30878,-106,1360000,0.6,136,609841
"5762",21792,-1298,1e+06,0.1,100,609941
"5451",1463,-565,490000,0.3,49,609990
"1284",34529,139,1990000,0.65,199,610189
"255",42801,1178,1500000,0.825,150,610339
"837",27846,655,1190000,0.775,119,610458
"1374",11692,207,560000,0.65,56,610514
"6406",4045,-1257,1e+06,0.1,100,610614
"1115",18477,179,2500000,0.65,250,610864
"2494",17224,-188,3150000,0.6,315,611179
"3126",10611,-215,3930000,0.6,393,611572
"2481",37078,-217,8e+05,0.6,80,611652
"1619",9066,202.5,1830000,0.65,183,611835
"4587",13522,-780,1990000,0.3,199,612034
"4261",37156,-693,1890000,0.3,189,612223
"2336",24213,73,8e+05,0.65,80,612303
"2952",11523,-180,7e+05,0.6,70,612373
"425",36694,645,7e+05,0.775,70,612443
"3660",29342,-377.5,1290000,0.6,129,612572
"2785",13208,-3,8e+05,0.6,80,612652
"6224",32681,-1369,490000,0.1,49,612701
"367",39867,1063,630000,0.825,63,612764
"1528",10043,222,490000,0.65,49,612813
"5409",26205,-994,720000,0.3,72,612885
"150",1370,1796.5,3390000,0.85,339,613224
"909",26373,953,2750000,0.775,275,613499
"2070",26805,131,1e+06,0.65,100,613599
"511",11637,566,1260000,0.775,126,613725
"3978",1816,-38,2300000,0.6,230,613955
"337",40394,1180,8e+05,0.825,80,614035
"1670",31530,273,3450000,0.65,345,614380
"2878",11833,-102,1290000,0.6,129,614509
"6845",32952,-1578,560000,0.05,56,614565
"6476",1349,-1149,8e+05,0.1,80,614645
"118",7228,1665,8e+05,0.85,80,614725
"1841",29277,287,7e+05,0.65,70,614795
"3735",28882,-209,7e+05,0.6,70,614865
"6359",5279,-1385,1e+06,0.1,100,614965
"4188",18010,-711,1e+06,0.3,100,615065
"3947",2249,-266.75,3760000,0.6,376,615441
"3036",33475,-20,640000,0.6,64,615505
"4498",14265,-773.5,1690000,0.3,169,615674
"3145",33052,-239,560000,0.6,56,615730
"1258",13259,305,1120000,0.65,112,615842
"5665",37181,-1064,9e+05,0.1,90,615932
"1743",7631,10,560000,0.65,56,615988
"516",33899,698,1850000,0.775,185,616173
"6175",10614,-1307,7e+05,0.1,70,616243
"1293",34544,55,3840000,0.65,384,616627
"2677",35716,-23,560000,0.6,56,616683
"417",38520,1182,7e+05,0.825,70,616753
"2142",40580,386,5300000,0.65,530,617283
"4759",11652,-995,2260000,0.3,226,617509
"6042",34707,-1397,560000,0.1,56,617565
"311",28112,1410,9e+05,0.825,90,617655
"1630",8970,105,2150000,0.65,215,617870
"3883",26676,-380,2800000,0.6,280,618150
"4497",14211,-932,1460000,0.3,146,618296
"5137",8348,-564,1760000,0.3,176,618472
"1130",37302,142,8e+05,0.65,80,618552
"1475",10206,417.5,1340000,0.65,134,618686
"3878",3429,-303,490000,0.6,49,618735
"3853",27064,-143,640000,0.6,64,618799
"245",9908,1050.33333333333,3450000,0.825,345,619144
"1352",33970,59,8e+05,0.65,80,619224
"2570",15250,-130,560000,0.6,56,619280
"1656",31574,262.5,3550000,0.65,355,619635
"4425",15022,-990,1e+06,0.3,100,619735
"2973",33671,-259.5,1890000,0.6,189,619924
"2597",36293,-271,1850000,0.6,185,620109
"1677",8356,2.6,5390000,0.65,539,620648
"3282",32754,-359,3590000,0.6,359,621007
"4350",16155,-546,2190000,0.3,219,621226
"5190",42298,-542.666666666667,2160000,0.3,216,621442
"1127",17889,90,810000,0.65,81,621523
"2325",38987,115,560000,0.65,56,621579
"715",6656,579,1700000,0.775,170,621749
"2354",38836,68,8e+05,0.65,80,621829
"3023",43112,-477,8e+05,0.6,80,621909
"6124",11036,-1023,9e+05,0.1,90,621999
"2686",35561,-478,7e+05,0.6,70,622069
"3331",32115,-173,490000,0.6,49,622118
"2631",35988,-59.5,1600000,0.6,160,622278
"2508",36902,-225,1800000,0.6,180,622458
"3726",29503,-259,10050000,0.6,1005,623463
"4651",34927,-879,4660000,0.3,466,623929
"2408",38078,-113,8e+05,0.6,80,624009
"568",32896,915,7e+05,0.775,70,624079
"4966",33008,-725,1830000,0.3,183,624262
"2694",35705,-419,3060000,0.6,306,624568
"548",10714,959,2620000,0.775,262,624830
"4672",12563,-564,1360000,0.3,136,624966
"1532",32685,417,2060000,0.65,206,625172
"2388",18936,-13,7e+05,0.6,70,625242
"5838",36407,-1297.5,2780000,0.1,278,625520
"2675",14168,-270,1990000,0.6,199,625719
"4619",35220,-893,1990000,0.3,199,625918
"2871",34386,-160,2260000,0.6,226,626144
"2612",36048,-217,3650000,0.6,365,626509
"2174",2223,449,7e+05,0.65,70,626579
"1549",9900,156.5,1930000,0.65,193,626772
"4602",13250,-647.333333333333,4090000,0.3,409,627181
"4323",16295,-995,490000,0.3,49,627230
"4552",14038,-787,1050000,0.3,105,627335
"4856",11088,-734.5,4820000,0.3,482,627817
"719",29079,614,560000,0.775,56,627873
"1454",33119,279,14200000,0.65,1420,629293
"1432",10419,147,490000,0.65,49,629342
"1228",35523,189,7e+05,0.65,70,629412
"3532",7949,-88,1350000,0.6,135,629547
"537",10965,925.5,1130000,0.775,113,629660
"3570",7684,-476,7e+05,0.6,70,629730
"1674",8318,118.5,1330000,0.65,133,629863
"2528",16108,-159,2450000,0.6,245,630108
"86",11712,1557,2260000,0.85,226,630334
"1778",7161,187,8e+05,0.65,80,630414
"1434",10503,34,7e+05,0.65,70,630484
"4842",10960,-852,1600000,0.3,160,630644
"4190",18144,-535,3200000,0.3,320,630964
"2769",13234,-263,7e+05,0.6,70,631034
"6585",37204,-1603,2160000,0.05,216,631250
"1666",31253,283,7e+05,0.65,70,631320
"3345",32033,-125,1050000,0.6,105,631425
"3910",26309,-23,9e+05,0.6,90,631515
"1984",5524,69,2960000,0.65,296,631811
"60",25912,2191,10390000,0.9,1039,632850
"1966",23019,379,1360000,0.65,136,632986
"3974",22299,-255,640000,0.6,64,633050
"6341",28489,-1107,1260000,0.1,126,633176
"3181",33154,-144,8e+05,0.6,80,633256
"1289",34388,85,560000,0.65,56,633312
"2235",39880,49,1120000,0.65,112,633424
"4863",10765,-935,8e+05,0.3,80,633504
"317",40900,1160,560000,0.825,56,633560
"201",34746,1146,1920000,0.825,192,633752
"5889",36271,-1242,1050000,0.1,105,633857
"763",5739,875,1990000,0.775,199,634056
"223",10720,1004,560000,0.825,56,634112
"672",29996,771,7e+05,0.775,70,634182
"5294",28341,-547.5,4200000,0.3,420,634602
"984",1782,868,7e+05,0.775,70,634672
"4010",1512,-353,4820000,0.6,482,635154
"5837",15239,-1181,560000,0.1,56,635210
"3369",8992,-283,1360000,0.6,136,635346
"6354",41790,-1301,2060000,0.1,206,635552
"3579",7560,-199,1990000,0.6,199,635751
"1018",39788,770,4190000,0.775,419,636170
"2713",35471,-2,1600000,0.6,160,636330
"2344",24136,68,560000,0.65,56,636386
"3509",8165,-435,1830000,0.6,183,636569
"405",38922,1187,1200000,0.825,120,636689
"2067",3871,310,560000,0.65,56,636745
"5404",2904,-681,640000,0.3,64,636809
"2510",23234,-144,8e+05,0.6,80,636889
"3474",8270,-80,1520000,0.6,152,637041
"4838",33594,-541,560000,0.3,56,637097
"2740",13458,-61,4930000,0.6,493,637590
"2770",13184,-128,490000,0.6,49,637639
"3663",42193,-371.285714285714,9340000,0.6,934,638573
"852",40952,555,3060000,0.775,306,638879
"3523",30741,-447,9e+05,0.6,90,638969
"2407",38125,-433,1260000,0.6,126,639095
"2730",43594,-174,2260000,0.6,226,639321
"2771",13280,-404,560000,0.6,56,639377
"4535",35695,-677.333333333333,5260000,0.3,526,639903
"3093",33386,-36,3060000,0.6,306,640209
"5935",35827,-1308,2700000,0.1,270,640479
"898",3069,611,9e+05,0.775,90,640569
"1883",29122,386,2190000,0.65,219,640788
"4377",44391,-880,640000,0.3,64,640852
"4748",43331,-931,2890000,0.3,289,641141
"2072",26991,175,8e+05,0.65,80,641221
"2737",35577,-497,13850000,0.6,1385,642606
"2704",23795,-189,8e+05,0.6,80,642686
"5255",28890,-705,490000,0.3,49,642735
"4636",34818,-915,5750000,0.3,575,643310
"4349",16160,-507,7e+05,0.3,70,643380
"4097",413,-105.5,1500000,0.6,150,643530
"3014",11154,-316,2190000,0.6,219,643749
"4990",33038,-632,11710000,0.3,1171,644920
"2808",12605,-324,1920000,0.6,192,645112
"4398",15445,-822,2790000,0.3,279,645391
"2087",26859,68,4040000,0.65,404,645795
"4690",43364,-986,1260000,0.3,126,645921
"5990",35239,-1094,7e+05,0.1,70,645991
"5890",14924,-1264,1260000,0.1,126,646117
"1923",28808,142,7e+05,0.65,70,646187
"2828",34663,-107,2420000,0.6,242,646429
"3549",30779,-344,2260000,0.6,226,646655
"1615",31883,342,1800000,0.65,180,646835
"3688",6337,-386,560000,0.6,56,646891
"4814",33659,-746.666666666667,3200000,0.3,320,647211
"918",40526,543,3350000,0.775,335,647546
"5770",16496,-1300,1750000,0.1,175,647721
"3370",9115,-339,8e+05,0.6,80,647801
"3765",5769,-190,1500000,0.6,150,647951
"850",4530,574,490000,0.775,49,648000
"563",10201,922,1520000,0.775,152,648152
"5540",38633,-920,640000,0.3,64,648216
"2908",11766,-471.5,2080000,0.6,208,648424
"3977",25960,-364,1920000,0.6,192,648616
"69",43704,1751,1360000,0.85,136,648752
"2742",13587,-233,1560000,0.6,156,648908
"1747",30496,136,1750000,0.65,175,649083
"6280",8191,-1183,2260000,0.1,226,649309
"4424",15473,-941,2500000,0.3,250,649559
"1846",6434,8.5,1260000,0.65,126,649685
"281",7338,1074,1800000,0.825,180,649865
"5977",35457,-1198,1260000,0.1,126,649991
"56",26801,2093,4060000,0.9,406,650397
"4881",10657,-800,8e+05,0.3,80,650477
"5023",9963,-892.5,1700000,0.3,170,650647
"3539",7881,-347,8e+05,0.6,80,650727
"2910",11674,-357,630000,0.6,63,650790
"4383",15436,-827.5,2090000,0.3,209,650999
"6437",40475,-1254,1280000,0.1,128,651127
"2961",33752,-287,490000,0.6,49,651176
"4704",11959,-709,560000,0.3,56,651232
"2108",26470,38,640000,0.65,64,651296
"1876",29114,251,1560000,0.65,156,651452
"4270",17088,-713,7e+05,0.3,70,651522
"1935",28992,161,3750000,0.65,375,651897
"3114",10602,-380,7e+05,0.6,70,651967
"4490",14288,-649,640000,0.3,64,652031
"4077",589,-128,1e+06,0.6,100,652131
"1241",13647,132,8e+05,0.65,80,652211
"2678",35694,-138,560000,0.6,56,652267
"5371",26850,-835,630000,0.3,63,652330
"897",40638,950,640000,0.775,64,652394
"1949",42046,31,7e+05,0.65,70,652464
"5228",29583,-920,7e+05,0.3,70,652534
"5060",8994,-828,1400000,0.3,140,652674
"2792",34788,-147,7e+05,0.6,70,652744
"2134",40566,438,1990000,0.65,199,652943
"5488",24689,-703,1190000,0.3,119,653062
"2978",43242,-312.5,1190000,0.6,119,653181
"3342",42717,-447,490000,0.6,49,653230
"5167",30932,-884,2730000,0.3,273,653503
"3890",20006,-445,2600000,0.6,260,653763
"2522",23142,-171,2890000,0.6,289,654052
"3104",10624,-441,7e+05,0.6,70,654122
"2921",11757,-348,1500000,0.6,150,654272
"3594",31191,-63,10190000,0.6,1019,655291
"1580",42798,201,1190000,0.65,119,655410
"3475",31506,-160,7050000,0.6,705,656115
"2793",12717,-331,1e+06,0.6,100,656215
"2519",16677,-186,1700000,0.6,170,656385
"2750",35085,-402.5,2480000,0.6,248,656633
"5144",8202,-897,720000,0.3,72,656705
"1462",44306,234,720000,0.65,72,656777
"2960",43167,-218.5,1050000,0.6,105,656882
"3392",8810,-96,7e+05,0.6,70,656952
"5116",31295,-715.5,1290000,0.3,129,657081
"1375",21510,340.5,1500000,0.65,150,657231
"1142",36767,116,490000,0.65,49,657280
"5732",36928,-1429,7e+05,0.1,70,657350
"517",23081,879,560000,0.775,56,657406
"4364",36793,-847,640000,0.3,64,657470
"180",35602,1224,490000,0.825,49,657519
"1360",11424,70,490000,0.65,49,657568
"2703",35433,-411.333333333333,2130000,0.6,213,657781
"2850",34355,-315,560000,0.6,56,657837
"1328",11733,452,9e+05,0.65,90,657927
"2950",33934,-342,1050000,0.6,105,658032
"4007",25722,-224,3560000,0.6,356,658388
"3654",29883,-11.3333333333333,5190000,0.6,519,658907
"1529",32755,14,490000,0.65,49,658956
"4545",13881,-713,7e+05,0.3,70,659026
"5061",31964,-675,560000,0.3,56,659082
"1447",33104,195,8e+05,0.65,80,659162
"793",28446,710,2060000,0.775,206,659368
"4326",16035,-963,560000,0.3,56,659424
"753",6030,621.5,3240000,0.775,324,659748
"2873",12035,-180,1190000,0.6,119,659867
"3155",42955,-204.5,2380000,0.6,238,660105
"2385",38482,453,7e+05,0.65,70,660175
"4390",36456,-603,630000,0.3,63,660238
"917",22711,799,640000,0.775,64,660302
"738",21096,542,7e+05,0.775,70,660372
"3255",32908,-49,8e+05,0.6,80,660452
"2744",13707,-179,8e+05,0.6,80,660532
"3571",30499,-163.5,2690000,0.6,269,660801
"2659",14197,-70.5,980000,0.6,98,660899
"4781",33986,-550,2360000,0.3,236,661135
"830",27956,519,3530000,0.775,353,661488
"6360",28465,-1037.75,3180000,0.1,318,661806
"302",28700,1167,8e+05,0.825,80,661886
"2127",40650,438,3420000,0.65,342,662228
"1055",38996,517,7e+05,0.775,70,662298
"290",6744,1265,560000,0.825,56,662354
"6306",30178,-1270.5,7510000,0.1,751,663105
"1623",8934,81,8e+05,0.65,80,663185
"282",7395,1059,560000,0.825,56,663241
"1150",43879,354,2190000,0.65,219,663460
"4747",11687,-702,8e+05,0.3,80,663540
"3558",30895,-59,6150000,0.6,615,664155
"5538",254,-932,2920000,0.3,292,664447
"4677",12406,-716,630000,0.3,63,664510
"781",5597,710,1e+06,0.775,100,664610
"5227",6640,-975,1e+06,0.3,100,664710
"4743",34167,-829,640000,0.3,64,664774
"4265",37066,-997,1e+06,0.3,100,664874
"227",10488,1443,640000,0.825,64,664938
"1403",11087,414,1e+06,0.65,100,665038
"5741",36931,-1306,560000,0.1,56,665094
"3361",31967,-447,7e+05,0.6,70,665164
"4127",38582,-203,2e+06,0.6,200,665364
"1999",27983,309,630000,0.65,63,665427
"5105",8558,-608,8e+05,0.3,80,665507
"1497",32913,167,7e+05,0.65,70,665577
"2040",20504,190,7e+05,0.65,70,665647
"185",13920,1207,3260000,0.825,326,665973
"4731",11844,-821,1600000,0.3,160,666133
"791",28377,796,560000,0.775,56,666189
"4663",34679,-833,1990000,0.3,199,666388
"244",9975,1064.33333333333,4290000,0.825,429,666817
"4568",13724,-998,7e+05,0.3,70,666887
"6843",42950,-1733,1530000,0.05,153,667040
"5729",37018,-1223,8e+05,0.1,80,667120
"253",32338,1436,7e+05,0.825,70,667190
"1980",5347,190,560000,0.65,56,667246
"3429",42593,-101.5,3760000,0.6,376,667622
"3881",3477,-374.5,1630000,0.6,163,667785
"5244",28986,-895,7e+05,0.3,70,667855
"3136",33175,-475,2260000,0.6,226,668081
"5559",23905,-920,8e+05,0.3,80,668161
"3397",31706,-294,2190000,0.6,219,668380
"3572",7372,-254,8e+05,0.6,80,668460
"3862",27202,-409,1050000,0.6,105,668565
"1595",32056,33,490000,0.65,49,668614
"3452",8672,-27,1260000,0.6,126,668740
"1254",35161,75,560000,0.65,56,668796
"4995",32920,-757,2890000,0.3,289,669085
"2240",25415,26,560000,0.65,56,669141
"1514",10068,367,8e+05,0.65,80,669221
"5430",1690,-706,1e+06,0.3,100,669321
"4507",35750,-888,2600000,0.3,260,669581
"3310",42826,-400,7e+05,0.6,70,669651
"2224",26032,82,5740000,0.65,574,670225
"3406",8655,-110.666666666667,2940000,0.6,294,670519
"6155",10693,-1024.5,1360000,0.1,136,670655
"4682",34586,-791,1620000,0.3,162,670817
"3091",10694,-145,490000,0.6,49,670866
"1210",35940,190,7e+05,0.65,70,670936
"993",39923,625,1800000,0.775,180,671116
"3526",30854,-1,720000,0.6,72,671188
"6874",9174,-1979,1700000,0.05,170,671358
"3575",30256,-228,9e+05,0.6,90,671448
"4239",17488,-749,7e+05,0.3,70,671518
"5170",30743,-728,720000,0.3,72,671590
"5483",39645,-516,1e+06,0.3,100,671690
"4844",11023,-897,2820000,0.3,282,671972
"1648",8913,384,8e+05,0.65,80,672052
"847",27285,722.5,1120000,0.775,112,672164
"5147",30954,-629,720000,0.3,72,672236
"816",5439,658,9e+05,0.775,90,672326
"5077",8814,-821.666666666667,2200000,0.3,220,672546
"4970",10345,-959,2310000,0.3,231,672777
"4571",35391,-787,560000,0.3,56,672833
"1198",43665,110,7e+05,0.65,70,672903
"1546",42846,388,8e+05,0.65,80,672983
"1554",32415,234,1e+06,0.65,100,673083
"560",10629,564,560000,0.775,56,673139
"2229",25799,126,560000,0.65,56,673195
"6212",33130,-1074,1700000,0.1,170,673365
"2823",34661,-123,3750000,0.6,375,673740
"2303",24531,142,5270000,0.65,527,674267
"504",11774,566,2e+06,0.775,200,674467
"755",44240,649,8e+05,0.775,80,674547
"3754",5863,-225,560000,0.6,56,674603
"4578",35346,-998,7e+05,0.3,70,674673
"6610",17141,-1531,490000,0.05,49,674722
"4783",33869,-670.333333333333,2660000,0.3,266,674988
"3288",32561,-17,1500000,0.6,150,675138
"203",12423,1386,810000,0.825,81,675219
"5995",35293,-1435,1500000,0.1,150,675369
"2425",37732,-230,1290000,0.6,129,675498
"4153",5,-697,560000,0.3,56,675554
"4204",37485,-691,490000,0.3,49,675603
"3826",4982,-472,490000,0.6,49,675652
"595",42871,547,7160000,0.775,716,676368
"5128",31058,-609,640000,0.3,64,676432
"3063",10812,-489,2410000,0.6,241,676673
"1703",42464,444.4,4890000,0.65,489,677162
"3992",40004,-496,490000,0.6,49,677211
"2326",38965,115,490000,0.65,49,677260
"2544",43871,-150,640000,0.6,64,677324
"2542",36549,-7,1270000,0.6,127,677451
"4928",10514,-696,560000,0.3,56,677507
"1158",43828,105,4920000,0.65,492,677999
"2717",13805,-432,2700000,0.6,270,678269
"5000",10210,-608,2410000,0.3,241,678510
"3540",30904,-432,2420000,0.6,242,678752
"980",1844,512,490000,0.775,49,678801
"3712",6064,-412,1e+06,0.6,100,678901
"1760",30079,148,2160000,0.65,216,679117
"2178",40262,143,1890000,0.65,189,679306
"5224",6857,-883,1e+06,0.3,100,679406
"4965",10319,-847,2420000,0.3,242,679648
"3149",10598,-25,8e+05,0.6,80,679728
"3718",29038,-140,1700000,0.6,170,679898
"4746",34483,-833,5660000,0.3,566,680464
"5422",26089,-989,1750000,0.3,175,680639
"1255",13176,239,1260000,0.65,126,680765
"4126",38543,-142.5,1900000,0.6,190,680955
"4867",10756,-748,8e+05,0.3,80,681035
"2527",16098,-67.5,1430000,0.6,143,681178
"1312",11978,219,560000,0.65,56,681234
"2191",2071,49,7e+05,0.65,70,681304
"3998",39902,-55,7e+05,0.6,70,681374
"2562",15418,-380,640000,0.6,64,681438
"309",21019,1193,1e+06,0.825,100,681538
"6524",38640,-1006,560000,0.1,56,681594
"1899",42061,432,490000,0.65,49,681643
"2861",12022,-130,1e+06,0.6,100,681743
"3306",32279,-301.333333333333,3310000,0.6,331,682074
"359",25680,1114,9e+05,0.825,90,682164
"5029",9616,-694,490000,0.3,49,682213
"3108",33297,-367,980000,0.6,98,682311
"4482",35953,-907,1290000,0.3,129,682440
"4929",33215,-761,1440000,0.3,144,682584
"4469",14442,-809,3210000,0.3,321,682905
"3152",33102,-326,1700000,0.6,170,683075
"2274",24742,282,1900000,0.65,190,683265
"4906",33345,-914,3320000,0.3,332,683597
"1235",13772,128,560000,0.65,56,683653
"2247",1444,65,630000,0.65,63,683716
"4408",23846,-634,1260000,0.3,126,683842
"970",40088,512,560000,0.775,56,683898
"2093",22927,308,560000,0.65,56,683954
"1486",32938,306,1690000,0.65,169,684123
"5460",25436,-635,8e+05,0.3,80,684203
"3799",5240,-141,560000,0.6,56,684259
"2368",38767,243,490000,0.65,49,684308
"6579",37332,-1858,640000,0.05,64,684372
"5162",23676,-789,720000,0.3,72,684444
"2019",40886,384,7e+05,0.65,70,684514
"1068",38885,647,1260000,0.775,126,684640
"2531",36566,-24,8e+05,0.6,80,684720
"3990",1682,-288,7e+05,0.6,70,684790
"1299",34328,118,490000,0.65,49,684839
"5306",28076,-885,490000,0.3,49,684888
"5865",14881,-1326,7e+05,0.1,70,684958
"3995",1686,-95.5,1050000,0.6,105,685063
"2670",14175,-134,1360000,0.6,136,685199
"6312",29633,-1303,7e+05,0.1,70,685269
"4892",10659,-696,1190000,0.3,119,685388
"5812",15642,-1273.5,1200000,0.1,120,685508
"419",37015,747,1200000,0.775,120,685628
"4776",34150,-539,4860000,0.3,486,686114
"4516",35711,-933.5,980000,0.3,98,686212
"372",1457,1243,1700000,0.825,170,686382
"1061",38905,911.5,1850000,0.775,185,686567
"3249",10014,-92,1e+06,0.6,100,686667
"4274",17349,-835,1190000,0.3,119,686786
"2776",34958,-276,7e+05,0.6,70,686856
"5384",26720,-920,560000,0.3,56,686912
"2484",37060,-74,3850000,0.6,385,687297
"1577",9278,283,1e+06,0.65,100,687397
"477",34941,559,560000,0.775,56,687453
"2473",17249,-318,7e+05,0.6,70,687523
"3324",9383,-114,2200000,0.6,220,687743
"1913",6200,295,7e+05,0.65,70,687813
"5380",40709,-927,2190000,0.3,219,688032
"789",5677,735,7e+05,0.775,70,688102
"6840",33180,-1832,8e+05,0.05,80,688182
"935",26159,646,560000,0.775,56,688238
"1237",13886,230,8e+05,0.65,80,688318
"5114",42536,-579,2260000,0.3,226,688544
"2710",13754,-136,1e+06,0.6,100,688644
"776",5946,656,490000,0.775,49,688693
"1671",8394,127,7e+05,0.65,70,688763
"3986",1925,-72,1900000,0.6,190,688953
"2748",35108,-319,1e+06,0.6,100,689053
"362",25570,1102,560000,0.825,56,689109
"4640",34900,-775,1520000,0.3,152,689261
"3739",42017,-225,1500000,0.6,150,689411
"4632",43558,-987,490000,0.3,49,689460
"3635",29694,-21,1700000,0.6,170,689630
"6958",3826,-1681,7e+05,0.05,70,689700
"4479",14567,-627,8e+05,0.3,80,689780
"4493",14324,-532,560000,0.3,56,689836
"6654",44410,-1836,7e+05,0.05,70,689906
"1246",13552,294,8e+05,0.65,80,689986
"5202",30077,-821,490000,0.3,49,690035
"4986",32790,-640,7e+05,0.3,70,690105
"3650",7035,-56,8e+05,0.6,80,690185
"5609",18258,-1351,1190000,0.1,119,690304
"2738",13329,-228,7e+05,0.6,70,690374
"713",29259,900,1750000,0.775,175,690549
"4443",14851,-962,490000,0.3,49,690598
"2221",40047,77,2260000,0.65,226,690824
"3914",26285,-22,490000,0.6,49,690873
"1233",35610,130,1360000,0.65,136,691009
"3260",32657,-54,8e+05,0.6,80,691089
"4116",23938,-166,1400000,0.6,140,691229
"5017",32682,-504,560000,0.3,56,691285
"363",25629,1296,2490000,0.825,249,691534
"5962",35596,-1003,1800000,0.1,180,691714
"2006",41126,239,640000,0.65,64,691778
"1070",38796,662,560000,0.775,56,691834
"2728",43587,-136,7e+05,0.6,70,691904
"4586",35186,-587.333333333333,2680000,0.3,268,692172
"3048",33447,-374,7e+05,0.6,70,692242
"3050",33435,-372,7e+05,0.6,70,692312
"1094",38636,916,7e+05,0.775,70,692382
"3525",7911,-1,630000,0.6,63,692445
"586",9874,656,2190000,0.775,219,692664
"4052",39416,-151,1350000,0.6,135,692799
"1506",32879,149,1190000,0.65,119,692918
"4689",12279,-526,1290000,0.3,129,693047
"495",34564,500,6630000,0.775,663,693710
"3930",2598,-19,1530000,0.6,153,693863
"2489",37025,-372,1990000,0.6,199,694062
"5773",36814,-1397,1990000,0.1,199,694261
"3740",5805,-383.666666666667,2700000,0.6,270,694531
"2386",19,274,560000,0.65,56,694587
"3941",26295,-417,4050000,0.6,405,694992
"4697",12489,-794,1830000,0.3,183,695175
"1865",6389,412,3950000,0.65,395,695570
"5315",28063,-835,8e+05,0.3,80,695650
"1340",11723,154,1360000,0.65,136,695786
"1724",30885,85,630000,0.65,63,695849
"2609",43737,-269,7e+05,0.6,70,695919
"1160",43806,13,630000,0.65,63,695982
"3100",33201,-152,3050000,0.6,305,696287
"4622",23763,-849,560000,0.3,56,696343
"2299",911,69,630000,0.65,63,696406
"1186",14360,4.5,5100000,0.65,510,696916
"3027",33481,-293.333333333333,2820000,0.6,282,697198
"5420",26079,-893,1800000,0.3,180,697378
"5694",21952,-1318,560000,0.1,56,697434
"3981",22286,-255,560000,0.6,56,697490
"6563",18036,-1577,560000,0.05,56,697546
"5302",28611,-963,12790000,0.3,1279,698825
"6515",38911,-1263,1360000,0.1,136,698961
"4916",10555,-698.25,3580000,0.3,358,699319
"3798",5283,-3.66666666666667,3600000,0.6,360,699679
"6458",25855,-1453,1e+06,0.1,100,699779
"2539",15603,-150,8e+05,0.6,80,699859
"1566",42840,279,4320000,0.65,432,700291
"3922",19558,-417,560000,0.6,56,700347
"3473",42432,-16,9e+05,0.6,90,700437
"248",32607,1243,8e+05,0.825,80,700517
"5109",23707,-874,490000,0.3,49,700566
"6729",14129,-1646,8e+05,0.05,80,700646
"5284",5664,-532,1990000,0.3,199,700845
"1828",29462,53,1e+06,0.65,100,700945
"1031",25235,571,12390000,0.775,1239,702184
"298",28984,1210,7e+05,0.825,70,702254
"13",22264,2858,8e+05,0.925,80,702334
"1278",12185,421,7e+05,0.65,70,702404
"1165",36263,417,1260000,0.65,126,702530
"952",26120,958,2190000,0.775,219,702749
"2697",35761,-229,2500000,0.6,250,702999
"5904",14562,-1242,560000,0.1,56,703055
"979",40144,512,7e+05,0.775,70,703125
"5547",145,-633,560000,0.3,56,703181
"1890",6426,152,1e+06,0.65,100,703281
"1746",7948,107,1690000,0.65,169,703450
"902",22892,584,1360000,0.775,136,703586
"1965",23021,111,3690000,0.65,369,703955
"3711",28903,-286,8e+05,0.6,80,704035
"2614",14776,-337,2700000,0.6,270,704305
"3379",31889,-328,2550000,0.6,255,704560
"1176",14742,50,2460000,0.65,246,704806
"5447",25571,-528,560000,0.3,56,704862
"891",40663,733,560000,0.775,56,704918
"2751",13258,-191.5,1400000,0.6,140,705058
"4612",13699,-522,3110000,0.3,311,705369
"5428",40018,-538,1e+06,0.3,100,705469
"231",10336,1443,720000,0.825,72,705541
"3368",9097,-299,1840000,0.6,184,705725
"4580",35331,-585,2890000,0.3,289,706014
"139",40454,1842,8e+05,0.85,80,706094
"3170",33062,-351.5,2140000,0.6,214,706308
"1252",35199,216,490000,0.65,49,706357
"5996",13399,-1289,9e+05,0.1,90,706447
"4044",829,-356,2650000,0.6,265,706712
"1986",41773,238.5,5760000,0.65,576,707288
"6589",17729,-1565,7e+05,0.05,70,707358
"2123",22853,444,560000,0.65,56,707414
"1282",34602,76,3750000,0.65,375,707789
"5606",18163,-1218.5,1400000,0.1,140,707929
"3623",7763,-79.5,1750000,0.6,175,708104
"1616",9010,438.5,1490000,0.65,149,708253
"3112",10557,-134,490000,0.6,49,708302
"632",8882,881,1500000,0.775,150,708452
"3897",22951,-462,8510000,0.6,851,709303
"314",41023,1381,560000,0.825,56,709359
"4063",725,-409,560000,0.6,56,709415
"2011",41139,52,9e+05,0.65,90,709505
"465",13495,559,8e+05,0.775,80,709585
"3408",8710,-367,7e+05,0.6,70,709655
"5808",36552,-1103,8e+05,0.1,80,709735
"2001",28007,309,9e+05,0.65,90,709825
"4666",12609,-540,3240000,0.3,324,710149
"1926",5838,339,8e+05,0.65,80,710229
"6489",25194,-1149,3740000,0.1,374,710603
"3109",21438,-246,4460000,0.6,446,711049
"3717",6046,-308,7e+05,0.6,70,711119
"2632",35989,-44,720000,0.6,72,711191
"4158",18571,-998,640000,0.3,64,711255
"1362",33901,193,7e+05,0.65,70,711325
"2294",39569,337,1280000,0.65,128,711453
"4727",11971,-829,560000,0.3,56,711509
"773",29158,836.5,6400000,0.775,640,712149
"519",33873,512,3880000,0.775,388,712537
"2262",39673,328,1050000,0.65,105,712642
"2284",39539,2,560000,0.65,56,712698
"5271",5851,-705,560000,0.3,56,712754
"3167",33076,-16,4190000,0.6,419,713173
"3628",29951,-100,3450000,0.6,345,713518
"4592",35501,-535,3260000,0.3,326,713844
"2896",11991,-229,3400000,0.6,340,714184
"827",41415,814,560000,0.775,56,714240
"2180",40305,194,2520000,0.65,252,714492
"6973",26222,-1640,3380000,0.05,338,714830
"2257",1134,328,8e+05,0.65,80,714910
"5811",15950,-1457,2620000,0.1,262,715172
"5524",374,-702,1400000,0.3,140,715312
"1357",33962,112,2260000,0.65,226,715538
"1907",6115,422,7e+05,0.65,70,715608
"4733",12002,-625,490000,0.3,49,715657
"3753",41814,-268,1260000,0.6,126,715783
"3256",32880,-341,1890000,0.6,189,715972
"5081",8791,-914,7e+05,0.3,70,716042
"4553",13811,-803,3490000,0.3,349,716391
"3907",26363,-278,560000,0.6,56,716447
"651",8798,592,490000,0.775,49,716496
"6940",5149,-1545,1690000,0.05,169,716665
"3665",42190,-367.75,4910000,0.6,491,717156
"4432",23842,-628,1360000,0.3,136,717292
"1240",13815,270,2500000,0.65,250,717542
"1069",38798,647,640000,0.775,64,717606
"758",6029,698.333333333333,2800000,0.775,280,717886
"1698",8098,493,720000,0.65,72,717958
"2551",36446,-249,9e+05,0.6,90,718048
"5491",24725,-710,490000,0.3,49,718097
"3682",44278,-270,7e+05,0.6,70,718167
"1872",42137,411,490000,0.65,49,718216
"4751",11802,-782.5,1460000,0.3,146,718362
"3587",30317,-351,8e+05,0.6,80,718442
"4423",15278,-710,1050000,0.3,105,718547
"2731",13645,-419,7e+05,0.6,70,718617
"1975",5473,484.333333333333,1890000,0.65,189,718806
"946",40193,705,7e+05,0.775,70,718876
"2877",34489,-227,7e+06,0.6,700,719576
"4207",37596,-971,640000,0.3,64,719640
"1036",865,528,640000,0.775,64,719704
"2499",16963,-292,560000,0.6,56,719760
"5113",31419,-674,1190000,0.3,119,719879
"2297",1013,155,9e+05,0.65,90,719969
"874",26903,776,490000,0.775,49,720018
"111",31135,1757.33333333333,4420000,0.85,442,720460
"6696",36166,-1702,7e+05,0.05,70,720530
"3821",41204,-437.666666666667,1920000,0.6,192,720722
"5296",28443,-635,1750000,0.3,175,720897
"3755",41929,-463,560000,0.6,56,720953
"4147",38183,-697,8e+05,0.3,80,721033
"4600",13562,-998,2550000,0.3,255,721288
"4539",35645,-520,6040000,0.3,604,721892
"4396",15495,-569,1990000,0.3,199,722091
"4193",18082,-571,630000,0.3,63,722154
"5187",7341,-881,490000,0.3,49,722203
"80",12316,1807,8e+05,0.85,80,722283
"1622",9216,176.5,1120000,0.65,112,722395
"1823",29402,340,8e+05,0.65,80,722475
"2008",41337,446,1050000,0.65,105,722580
"1741",30644,107,560000,0.65,56,722636
"4454",43783,-849,12480000,0.3,1248,723884
"2654",35969,-316,560000,0.6,56,723940
"3667",29926,-26,1260000,0.6,126,724066
"4707",12083,-769,8e+05,0.3,80,724146
"5094",31624,-676,1820000,0.3,182,724328
"1483",10284,270,1050000,0.65,105,724433
"1267",12703,195,8e+05,0.65,80,724513
"6213",10328,-1080,4640000,0.1,464,724977
"2079",4016,259,1190000,0.65,119,725096
"6",13505,2612,490000,0.925,49,725145
"824",5067,519,9e+05,0.775,90,725235
"3171",10376,-35,1190000,0.6,119,725354
"3177",10302,-246.5,2340000,0.6,234,725588
"4413",36408,-888,560000,0.3,56,725644
"6010",13369,-1162,7e+05,0.1,70,725714
"4514",14239,-905,5020000,0.3,502,726216
"4272",37057,-545,7e+05,0.3,70,726286
"6957",26935,-1662,1500000,0.05,150,726436
"1972",21001,419.5,4410000,0.65,441,726877
"4332",36696,-990,2460000,0.3,246,727123
"6571",17803,-1550,2980000,0.05,298,727421
"3503",30856,-442,640000,0.6,64,727485
"3802",28097,-200,9e+05,0.6,90,727575
"4491",14118,-629,2990000,0.3,299,727874
"6349",5819,-1154,4110000,0.1,411,728285
"3357",31918,-1,8e+05,0.6,80,728365
"2851",12139,-142,1050000,0.6,105,728470
"5424",1918,-906,640000,0.3,64,728534
"2261",39747,402,2550000,0.65,255,728789
"1231",35722,273,1190000,0.65,119,728908
"2518",16786,-26,1190000,0.6,119,729027
"5728",17046,-1199,8e+05,0.1,80,729107
"5470",25389,-748,720000,0.3,72,729179
"2657",35920,-291,490000,0.6,49,729228
"2373",24027,180,7e+05,0.65,70,729298
"2490",17260,-217,7e+05,0.6,70,729368
"259",32010,1384.5,2520000,0.825,252,729620
"5019",10054,-973,560000,0.3,56,729676
"3461",42463,-133,8e+05,0.6,80,729756
"2166",2330,153.5,2950000,0.65,295,730051
"5359",27884,-512,20870000,0.3,2087,732138
"4244",17655,-664,2850000,0.3,285,732423
"6170",33290,-1208,5530000,0.1,553,732976
"1891",6122,453,8e+05,0.65,80,733056
"3541",30513,-430,640000,0.6,64,733120
"3348",9127,-264,1190000,0.6,119,733239
"3599",30629,-142,5300000,0.6,530,733769
"4409",23850,-557,490000,0.3,49,733818
"4605",13386,-915,1e+06,0.3,100,733918
"3581",30232,-345,1800000,0.6,180,734098
"3707",42115,-98,1500000,0.6,150,734248
"2111",40624,438,1460000,0.65,146,734394
"6189",10550,-1363,1360000,0.1,136,734530
"655",31501,607,2450000,0.775,245,734775
"5833",15302,-1016,640000,0.1,64,734839
"2804",34694,-78,560000,0.6,56,734895
"2056",27024,418,7e+05,0.65,70,734965
"1953",5653,250,560000,0.65,56,735021
"4911",10741,-931,3950000,0.3,395,735416
"1346",11848,120,8e+05,0.65,80,735496
"2883",11756,-31.5,1500000,0.6,150,735646
"193",35114,1183,5490000,0.825,549,736195
"3417",8665,-223,7e+05,0.6,70,736265
"1669",31225,497,1120000,0.65,112,736377
"5180",7819,-578,1050000,0.3,105,736482
"2768",13157,-359,490000,0.6,49,736531
"3957",40205,-431,560000,0.6,56,736587
"4941",42947,-798,2060000,0.3,206,736793
"3292",9860,-341,1260000,0.6,126,736919
"5293",28279,-806,560000,0.3,56,736975
"705",29162,614,1e+06,0.775,100,737075
"3772",5536,-463.5,3480000,0.6,348,737423
"3085",10780,-2.5,2170000,0.6,217,737640
"3672",6594,-137,1430000,0.6,143,737783
"157",24231,1586,7e+05,0.85,70,737853
"3098",33226,-333,560000,0.6,56,737909
"4353",15908,-629,1990000,0.3,199,738108
"2068",27104,104,2500000,0.65,250,738358
"2487",37091,-226.166666666667,8220000,0.6,822,739180
"1008",25078,941,560000,0.775,56,739236
"3643",7146,-26,640000,0.6,64,739300
"1338",21527,123.333333333333,2160000,0.65,216,739516
"3450",8335,-450,490000,0.6,49,739565
"5213",29638,-597,1e+06,0.3,100,739665
"6313",29613,-1140,1500000,0.1,150,739815
"2223",1738,97,7e+05,0.65,70,739885
"6604",17428,-1565,980000,0.05,98,739983
"4245",37319,-507,3400000,0.3,340,740323
"3640",42236,-411,1990000,0.6,199,740522
"4988",32772,-664,7e+05,0.3,70,740592
"501",21560,748,810000,0.775,81,740673
"3423",23715,-451,8e+05,0.6,80,740753
"561",32891,664,1270000,0.775,127,740880
"2929",11745,-376,1360000,0.6,136,741016
"4318",16575,-995,8e+05,0.3,80,741096
"2141",26361,0,3060000,0.65,306,741402
"2630",14600,-266,2720000,0.6,272,741674
"6055",34272,-1261.5,2060000,0.1,206,741880
"6274",23685,-1092,630000,0.1,63,741943
"785",41684,545,1700000,0.775,170,742113
"6277",23693,-1074,2800000,0.1,280,742393
"5835",44380,-1058,2340000,0.1,234,742627
"4172",37914,-956,490000,0.3,49,742676
"4299",16904,-832,8e+05,0.3,80,742756
"2414",37747,-196,1400000,0.6,140,742896
"3554",8036,-131,1490000,0.6,149,743045
"19",812,2709,560000,0.925,56,743101
"3298",32974,-292,13340000,0.6,1334,744435
"3928",40447,-47,9e+05,0.6,90,744525
"3780",41594,-150,7e+05,0.6,70,744595
"2874",34349,-133,2560000,0.6,256,744851
"242",10127,1424.5,1290000,0.825,129,744980
"886",3563,620,560000,0.775,56,745036
"1019",39748,791,1530000,0.775,153,745189
"441",14571,852,640000,0.775,64,745253
"3697",6170,-412,1750000,0.6,175,745428
"3793",41508,-106,1190000,0.6,119,745547
"5254",6143,-710,490000,0.3,49,745596
"6247",8950,-1016,7e+05,0.1,70,745666
"5479",24943,-538,1260000,0.3,126,745792
"1200",35778,457,2960000,0.65,296,746088
"3609",29864,-393,1560000,0.6,156,746244
"2593",36270,-287,560000,0.6,56,746300
"1765",30010,383,560000,0.65,56,746356
"3235",10139,-55,2940000,0.6,294,746650
"4617",35142,-866,560000,0.3,56,746706
"3352",31927,-267,1820000,0.6,182,746888
"856",27143,664,640000,0.775,64,746952
"4724",11965,-585,1260000,0.3,126,747078
"2416",37890,-433,2360000,0.6,236,747314
"4168",38075,-735,3090000,0.3,309,747623
"2997",33611,-432,1e+06,0.6,100,747723
"5952",13992,-1067.5,1950000,0.1,195,747918
"6222",32866,-1480,8400000,0.1,840,748758
"743",28941,577,560000,0.775,56,748814
"2937",21517,-348,1e+06,0.6,100,748914
"2546",23854,-474,720000,0.6,72,748986
"1768",7197,172,7e+05,0.65,70,749056
"857",4276,810,8e+05,0.775,80,749136
"1420",43007,244,1990000,0.65,199,749335
"2379",38625,284,8e+05,0.65,80,749415
"1732",7877,237,9e+05,0.65,90,749505
"4525",35731,-652.5,2750000,0.3,275,749780
"2963",33843,-392,7e+05,0.6,70,749850
"6417",40644,-1203,8e+05,0.1,80,749930
"5533",23921,-641,1e+06,0.3,100,750030
"4121",38666,-158,560000,0.6,56,750086
"2395",38208,-380,1190000,0.6,119,750205
"3132",44309,-369.5,6360000,0.6,636,750841
"2046",5013,405.333333333333,4730000,0.65,473,751314
"1600",31939,112,1750000,0.65,175,751489
"1330",11592,156,3100000,0.65,310,751799
"2431",18069,-230,7e+05,0.6,70,751869
"6291",7701,-1050,640000,0.1,64,751933
"4031",24958,-480,560000,0.6,56,751989
"5425",26001,-785,560000,0.3,56,752045
"5090",31579,-661,7e+05,0.3,70,752115
"631",31751,999,560000,0.775,56,752171
"4062",39030,-300,7e+05,0.6,70,752241
"806",28229,898,630000,0.775,63,752304
"2560",15296,-25.3333333333333,2750000,0.6,275,752579
"2177",26170,67,490000,0.65,49,752628
"1406",11014,142,8e+05,0.65,80,752708
"5141",8520,-744,1360000,0.3,136,752844
"5206",30084,-559,2450000,0.3,245,753089
"101",9347,1875,7e+05,0.85,70,753159
"3374",31853,-126,560000,0.6,56,753215
"5510",584,-564,1990000,0.3,199,753414
"2058",27044,392,1e+06,0.65,100,753514
"3206",32892,-348,1190000,0.6,119,753633
"896",26512,706,640000,0.775,64,753697
"2249",1356,62,720000,0.65,72,753769
"2517",17158,-494,4060000,0.6,406,754175
"160",38259,1005,1400000,0.825,140,754315
"2587",36268,-61,8e+05,0.6,80,754395
"1707",42419,82,8e+05,0.65,80,754475
"4260",37194,-742,7e+05,0.3,70,754545
"1096",38620,534,560000,0.775,56,754601
"6032",34864,-1064.5,2330000,0.1,233,754834
"3757",28761,-311,7e+05,0.6,70,754904
"6228",32699,-1007,1500000,0.1,150,755054
"3841",27299,-489,7e+05,0.6,70,755124
"6952",3979,-1516,1e+06,0.05,100,755224
"4955",33003,-954,1120000,0.3,112,755336
"5134",8237,-629,640000,0.3,64,755400
"2547",15479,-474,9e+05,0.6,90,755490
"6076",43315,-1440,8e+05,0.1,80,755570
"1106",18876,254,490000,0.65,49,755619
"4872",10767,-512,7e+05,0.3,70,755689
"4458",14557,-585.666666666667,3460000,0.3,346,756035
"1684",31351,166,3840000,0.65,384,756419
"3869",26837,-144,560000,0.6,56,756475
"5484",997,-516,8e+05,0.3,80,756555
"1172",44369,285,1490000,0.65,149,756704
"5389",3410,-899,7e+05,0.3,70,756774
"1544",32622,415,1920000,0.65,192,756966
"1863",6374,56,7e+05,0.65,70,757036
"2086",26816,253,1190000,0.65,119,757155
"3049",10963,-36,2e+06,0.6,200,757355
"3451",31495,-178,3380000,0.6,338,757693
"3360",42697,-332,5510000,0.6,551,758244
"5923",14329,-1269,560000,0.1,56,758300
"1418",10654,322,1750000,0.65,175,758475
"1960",28413,251,8e+05,0.65,80,758555
"3786",28356,-106,1e+06,0.6,100,758655
"5151",42396,-571,2460000,0.3,246,758901
"427",15926,532,8e+05,0.775,80,758981
"2322",24299,236,3760000,0.65,376,759357
"4372",36571,-931,8e+05,0.3,80,759437
"6081",34064,-1217,630000,0.1,63,759500
"2779",34835,-220,1050000,0.6,105,759605
"5247",42117,-951,1260000,0.3,126,759731
"4456",36131,-506.333333333333,3880000,0.3,388,760119
"2509",36899,-144,7e+05,0.6,70,760189
"5640",17716,-1190,1350000,0.1,135,760324
"520",33950,998,2680000,0.775,268,760592
"1536",21381,452,560000,0.65,56,760648
"4674",12484,-678,1720000,0.3,172,760820
"3805",41680,-32,7310000,0.6,731,761551
"1203",14248,487,1750000,0.65,175,761726
"4817",11374,-655,7e+05,0.3,70,761796
"4064",671,-409,7e+05,0.6,70,761866
"3885",26595,-443,1e+06,0.6,100,761966
"6135",10954,-1359,1990000,0.1,199,762165
"2285",926,155,1280000,0.65,128,762293
"5231",29153,-919,8e+05,0.3,80,762373
"2847",12873,-196,3660000,0.6,366,762739
"1783",29627,330,7e+05,0.65,70,762809
"2778",13020,-403,490000,0.6,49,762858
"291",6435,1310,1e+06,0.825,100,762958
"466",35444,650,3890000,0.775,389,763347
"1218",35696,296,1700000,0.65,170,763517
"4780",11527,-882,7e+05,0.3,70,763587
"420",17047,620,2060000,0.775,206,763793
"4868",33342,-943,7e+05,0.3,70,763863
"5068",8937,-578,490000,0.3,49,763912
"940",19368,912,490000,0.775,49,763961
"5343",41049,-555,490000,0.3,49,764010
"2712",35437,-181,7e+05,0.6,70,764080
"4043",24680,-412,3390000,0.6,339,764419
"4609",13082,-780,7e+05,0.3,70,764489
"4445",36226,-768,1190000,0.3,119,764608
"673",7133,771,560000,0.775,56,764664
"2521",16308,-159,1190000,0.6,119,764783
"2242",25796,474.5,6320000,0.65,632,765415
"2606",14617,-455,7e+05,0.6,70,765485
"3695",44293,-248,1050000,0.6,105,765590
"6315",6617,-1281,8e+05,0.1,80,765670
"2347",38861,178,640000,0.65,64,765734
"1173",14829,210,1360000,0.65,136,765870
"484",43492,766,640000,0.775,64,765934
"2575",15358,-300,3280000,0.6,328,766262
"4059",24296,-93,1700000,0.6,170,766432
"3478",8378,-372,9e+05,0.6,90,766522
"2965",21504,-5,490000,0.6,49,766571
"5445",25561,-895,7e+05,0.3,70,766641
"6140",33504,-1179,7e+05,0.1,70,766711
"876",3925,838,7e+05,0.775,70,766781
"4057",648,-12,8e+05,0.6,80,766861
"4301",36911,-795,7e+05,0.3,70,766931
"1393",11217,0,1700000,0.65,170,767101
"1320",11771,448,2070000,0.65,207,767308
"6920",6619,-1503,980000,0.05,98,767406
"4615",13201,-707,560000,0.3,56,767462
"3651",29499,-235.5,1360000,0.6,136,767598
"1884",28994,411,7e+05,0.65,70,767668
"770",28516,545,490000,0.775,49,767717
"949",26286,595.5,17350000,0.775,1735,769452
"5558",29,-670,3630000,0.3,363,769815
"5660",17569,-1182.66666666667,3690000,0.1,369,770184
"5270",28791,-905.333333333333,1620000,0.3,162,770346
"4374",15448,-716,560000,0.3,56,770402
"6670",15111,-1744,7e+05,0.05,70,770472
"1056",38997,517,560000,0.775,56,770528
"4407",15428,-941,1200000,0.3,120,770648
"808",28222,762,1750000,0.775,175,770823
"262",31760,1378,2250000,0.825,225,771048
"2802",12610,-270,640000,0.6,64,771112
"5994",35268,-1435,1e+06,0.1,100,771212
"4234",17688,-834,2060000,0.3,206,771418
"5880",14836,-1039,1190000,0.1,119,771537
"4144",38300,-835,2360000,0.3,236,771773
"1626",31860,231,5500000,0.65,550,772323
"2342",24171,23,490000,0.65,49,772372
"4566",13787,-927,1700000,0.3,170,772542
"507",11597,654.5,3350000,0.775,335,772877
"1982",28189,30,7e+05,0.65,70,772947
"6016",13059,-1376,7e+05,0.1,70,773017
"1112",38031,6,1990000,0.65,199,773216
"1874",42118,330,7e+05,0.65,70,773286
"1560",32627,31,1700000,0.65,170,773456
"1508",32715,160,7e+05,0.65,70,773526
"4378",36497,-520.333333333333,1910000,0.3,191,773717
"4",22424,3087,7e+05,0.95,70,773787
"2469",17367,-185,560000,0.6,56,773843
"3039",33433,-490,3950000,0.6,395,774238
"5059",32076,-996,8e+05,0.3,80,774318
"114",30455,1975,1850000,0.85,185,774503
"1113",38067,312,1750000,0.65,175,774678
"6870",9155,-1598,7e+05,0.05,70,774748
"6022",13130,-1486,1540000,0.1,154,774902
"4263",17526,-701,4250000,0.3,425,775327
"3169",10231,-174,1520000,0.6,152,775479
"4945",33054,-546,2330000,0.3,233,775712
"4303",16988,-626,1750000,0.3,175,775887
"2842",12285,-478,490000,0.6,49,775936
"558",10258,797,2330000,0.775,233,776169
"200",34673,1231,9e+05,0.825,90,776259
"2567",36495,-460,1200000,0.6,120,776379
"3009",33910,-466,1850000,0.6,185,776564
"3838",41188,-345,1190000,0.6,119,776683
"4974",10276,-721,490000,0.3,49,776732
"4440",36298,-818,8e+05,0.3,80,776812
"1371",11429,147,2680000,0.65,268,777080
"249",32384,1120,8e+05,0.825,80,777160
"1800",29733,451,490000,0.65,49,777209
"3046",11169,-387,1050000,0.6,105,777314
"2688",13874,-70.4,6560000,0.6,656,777970
"6080",21548,-1482,9e+05,0.1,90,778060
"3037",33498,-402.333333333333,4110000,0.6,411,778471
"5304",28254,-896,1190000,0.3,119,778590
"3168",10249,-174.666666666667,5340000,0.6,534,779124
"365",1448,1296,560000,0.825,56,779180
"1511",32842,346,5540000,0.65,554,779734
"140",40433,1566,560000,0.85,56,779790
"1826",29483,492.666666666667,3310000,0.65,331,780121
"4385",36508,-841,1350000,0.3,135,780256
"1777",7286,253.5,1460000,0.65,146,780402
"3791",5594,-274,1190000,0.6,119,780521
"3222",10111,-238.5,3500000,0.6,350,780871
"3486",8251,-410,630000,0.6,63,780934
"6326",6123,-1049,560000,0.1,56,780990
"6316",42194,-1178,1050000,0.1,105,781095
"3356",32014,-143,1600000,0.6,160,781255
"2882",43341,-125,3690000,0.6,369,781624
"4546",35470,-881.5,3060000,0.3,306,781930
"5093",31638,-687.5,2900000,0.3,290,782220
"373",39944,1094,5620000,0.825,562,782782
"4921",10572,-994.5,2160000,0.3,216,782998
"4500",14144,-941.5,2310000,0.3,231,783229
"250",32590,1120,3700000,0.825,370,783599
"1098",38618,821,9e+05,0.775,90,783689
"5364",4297,-522,7e+05,0.3,70,783759
"2991",11196,-482,7e+05,0.6,70,783829
"1763",7253,50,560000,0.65,56,783885
"5691",17280,-1415,490000,0.1,49,783934
"3680",44287,-305,630000,0.6,63,783997
"81",34308,1760,8e+05,0.85,80,784077
"6948",27560,-1613,8e+05,0.05,80,784157
"6378",41137,-1171,7e+05,0.1,70,784227
"399",586,1044,1560000,0.825,156,784383
"525",43173,671,490000,0.775,49,784432
"5349",4818,-613,1190000,0.3,119,784551
"4992",10162,-690,1190000,0.3,119,784670
"4096",24101,-398,1260000,0.6,126,784796
"99",9659,1695,560000,0.85,56,784852
"6215",10203,-1076,1500000,0.1,150,785002
"4248",17542,-932.666666666667,2700000,0.3,270,785272
"11",28295,2996,8e+06,0.925,800,786072
"3553",30324,-392,8e+05,0.6,80,786152
"3195",33056,-63,3280000,0.6,328,786480
"5419",26167,-834,4150000,0.3,415,786895
"3588",30115,-98,1e+06,0.6,100,786995
"4401",36401,-762,560000,0.3,56,787051
"5053",9139,-920,560000,0.3,56,787107
"797",28479,793,1360000,0.775,136,787243
"4202",17910,-711,7e+05,0.3,70,787313
"2310",24329,443,1e+06,0.65,100,787413
"3001",11339,-351,490000,0.6,49,787462
"1603",9226,359,7e+05,0.65,70,787532
"5441",25731,-893.5,1960000,0.3,196,787728
"1064",38973,598,1190000,0.775,119,787847
"1539",9957,115,1440000,0.65,144,787991
"5356",4714,-756,560000,0.3,56,788047
"4686",34691,-678,8e+05,0.3,80,788127
"4142",18780,-895,3790000,0.3,379,788506
"1147",15854,282.5,1910000,0.65,191,788697
"4112",23954,-314,560000,0.6,56,788753
"3214",10138,-17,2060000,0.6,206,788959
"492",12055,704,1500000,0.775,150,789109
"4756",11605,-526,9e+05,0.3,90,789199
"2353",38824,219,640000,0.65,64,789263
"5481",25119,-636.25,6340000,0.3,634,789897
"1414",10898,44,1990000,0.65,199,790096
"2989",11311,-428.5,1800000,0.6,180,790276
"6882",8800,-1564,7e+05,0.05,70,790346
"2306",39232,260,1900000,0.65,190,790536
"3731",42153,-135,4300000,0.6,430,790966
"5542",192,-920,720000,0.3,72,791038
"2334",38974,477,1700000,0.65,170,791208
"1801",29532,451,7e+05,0.65,70,791278
"2667",35759,-23,1990000,0.6,199,791477
"3021",33492,-399,7e+05,0.6,70,791547
"181",35663,1305,1190000,0.825,119,791666
"4009",1402,-334,1280000,0.6,128,791794
"3602",29865,-85,7e+05,0.6,70,791864
"3794",41665,-106,2060000,0.6,206,792070
"1453",44317,234,640000,0.65,64,792134
"2879",34304,-271,490000,0.6,49,792183
"6131",11045,-1496.5,2400000,0.1,240,792423
"1162",15124,342,1500000,0.65,150,792573
"5013",10010,-649,1260000,0.3,126,792699
"6273",23690,-1074,9e+05,0.1,90,792789
"1696",8167,34,720000,0.65,72,792861
"4276",37083,-924,2190000,0.3,219,793080
"1515",21392,65,1700000,0.65,170,793250
"6597",17365,-1853,560000,0.05,56,793306
"6286",8054,-1315,720000,0.1,72,793378
"1756",7384,36,7e+05,0.65,70,793448
"5210",30583,-609,5500000,0.3,550,793998
"1221",14052,486,1260000,0.65,126,794124
"4189",37578,-670,7e+05,0.3,70,794194
"5337",29418,-832,1990000,0.3,199,794393
"4163",18503,-614,2750000,0.3,275,794668
"3120",42969,-277.5,7850000,0.6,785,795453
"4222",37385,-904,1190000,0.3,119,795572
"4352",15780,-967.5,2520000,0.3,252,795824
"1109",18585,96,1700000,0.65,170,795994
"930",40303,566,560000,0.775,56,796050
"5486",24740,-646,1e+06,0.3,100,796150
"3604",42246,-347.666666666667,2290000,0.6,229,796379
"5553",38477,-654,560000,0.3,56,796435
"947",40168,646,8e+05,0.775,80,796515
"3555",30565,-374,560000,0.6,56,796571
"6614",36994,-1517,7e+05,0.05,70,796641
"3781",41675,-133,1050000,0.6,105,796746
"5049",42824,-773,3810000,0.3,381,797127
"6060",34260,-1387,7e+05,0.1,70,797197
"665",30719,934.333333333333,2550000,0.775,255,797452
"2890",34245,-333,2060000,0.6,206,797658
"2892",34268,-252.5,1770000,0.6,177,797835
"2933",34113,-156,3860000,0.6,386,798221
"4752",43301,-727,810000,0.3,81,798302
"6480",25136,-1495,640000,0.1,64,798366
"1129",37229,320,8e+05,0.65,80,798446
"207",12093,1424,1400000,0.825,140,798586
"4794",21506,-787,7e+05,0.3,70,798656
"3305",32559,-163,1990000,0.6,199,798855
"1206",35728,364.5,1490000,0.65,149,799004
"4926",10470,-546,640000,0.3,64,799068
"4477",14326,-663,560000,0.3,56,799124
"4803",11366,-634.333333333333,2750000,0.3,275,799399
"3597",7223,-479,560000,0.6,56,799455
"4141",38313,-659,1e+06,0.3,100,799555
"639",42600,705,1820000,0.775,182,799737
"4233",37283,-696,8e+05,0.3,80,799817
"4594",43596,-542,2400000,0.3,240,800057
"3508",30757,-413,640000,0.6,64,800121
"5155",30934,-636,2420000,0.3,242,800363
"792",28558,658,3110000,0.775,311,800674
"1103",90,744,8e+05,0.775,80,800754
"5316",41453,-780,5690000,0.3,569,801323
"5062",31736,-723,8e+05,0.3,80,801403
"4269",17341,-953,2620000,0.3,262,801665
"3874",26736,-67,8e+05,0.6,80,801745
"1477",44310,116.5,3970000,0.65,397,802142
"3813",5063,-496,1920000,0.6,192,802334
"4334",36754,-967.5,3450000,0.3,345,802679
"4416",15282,-584,2200000,0.3,220,802899
"786",28351,780,1500000,0.775,150,803049
"4083",38808,-295,8e+05,0.6,80,803129
"775",44248,649,2460000,0.775,246,803375
"1944",5880,494,2060000,0.65,206,803581
"4410",23855,-972,1050000,0.3,105,803686
"6847",42912,-1700,560000,0.05,56,803742
"5333",27767,-909,7e+05,0.3,70,803812
"2906",11834,-202,1360000,0.6,136,803948
"4037",24509,-418,490000,0.6,49,803997
"2380",38606,292,1280000,0.65,128,804125
"1767",7145,187,1890000,0.65,189,804314
"1930",28875,296,1800000,0.65,180,804494
"2986",33826,-126,1400000,0.6,140,804634
"829",5114,653,8e+05,0.775,80,804714
"922",19410,791,8e+05,0.775,80,804794
"4660",12637,-786,560000,0.3,56,804850
"2994",43155,-384,1500000,0.6,150,805000
"3115",33151,-256,560000,0.6,56,805056
"4875",33307,-979,7e+05,0.3,70,805126
"265",42560,1070,8e+05,0.825,80,805206
"5949",14055,-1229,1990000,0.1,199,805405
"4356",16071,-576,7e+05,0.3,70,805475
"788",21040,656,7e+05,0.775,70,805545
"3534",30774,-360.5,1120000,0.6,112,805657
"2729",13630,-175,490000,0.6,49,805706
"6862",9479,-1747,560000,0.05,56,805762
"3146",33182,-424,6240000,0.6,624,806386
"1149",43913,414,3480000,0.65,348,806734
"5381",40774,-813,6880000,0.3,688,807422
"2898",34102,-143,2800000,0.6,280,807702
"6683",14937,-1595,1190000,0.05,119,807821
"3106",33246,-198,7e+05,0.6,70,807891
"1992",28101,471,8e+05,0.65,80,807971
"3652",29770,-302,640000,0.6,64,808035
"1334",11824,343,1500000,0.65,150,808185
"4367",36632,-985,2070000,0.3,207,808392
"5276",5960,-951.5,1340000,0.3,134,808526
"3028",11016,-236,1440000,0.6,144,808670
"6218",32855,-1067,3350000,0.1,335,809005
"1090",24024,537,3500000,0.775,350,809355
"6774",43472,-1950,8e+05,0.05,80,809435
"1493",10180,325,1560000,0.65,156,809591
"2884",11856,-359.5,1280000,0.6,128,809719
"115",30469,1952,490000,0.85,49,809768
"5199",21208,-938,6190000,0.3,619,810387
"3163",10329,-477,9e+05,0.6,90,810477
"6955",27077,-1520,490000,0.05,49,810526
"6941",41340,-1523,720000,0.05,72,810598
"163",44023,1276,2890000,0.825,289,810887
"4267",37082,-803,1e+06,0.3,100,810987
"1558",9685,67,1e+06,0.65,100,811087
"162",37276,1276,720000,0.825,72,811159
"276",42507,1205.5,2170000,0.825,217,811376
"5821",15382,-1379,630000,0.1,63,811439
"5217",6841,-650,7e+05,0.3,70,811509
"6565",37556,-1593,640000,0.05,64,811573
"4368",15632,-599.5,1460000,0.3,146,811719
"486",34672,979,1350000,0.775,135,811854
"2446",17783,-121,1200000,0.6,120,811974
"5870",14848,-1365,1e+06,0.1,100,812074
"5127",8492,-543,560000,0.3,56,812130
"4813",43152,-510,1190000,0.3,119,812249
"4128",74,-250,1e+06,0.6,100,812349
"3251",32719,-55.5,1490000,0.6,149,812498
"1916",28968,366,4950000,0.65,495,812993
"4675",34716,-570,1620000,0.3,162,813155
"5663",37237,-1430,1400000,0.1,140,813295
"4582",35173,-731,490000,0.3,49,813344
"716",29581,699,2620000,0.775,262,813606
"737",28985,770,7e+05,0.775,70,813676
"3013",33610,-257,3460000,0.6,346,814022
"3218",32864,-425,1800000,0.6,180,814202
"6269",8470,-1111,8e+05,0.1,80,814282
"3694",6282,-94.5,1400000,0.6,140,814422
"1840",6592,287,8e+05,0.65,80,814502
"2763",13194,-420.5,1190000,0.6,119,814621
"2033",27474,398,560000,0.65,56,814677
"5726",17257,-1429,1850000,0.1,185,814862
"4550",35463,-656,560000,0.3,56,814918
"587",21375,935,640000,0.775,64,814982
"1135",17327,76,1360000,0.65,136,815118
"795",28289,656,1290000,0.775,129,815247
"4623",34984,-606.333333333333,4190000,0.3,419,815666
"6529",132,-1218,640000,0.1,64,815730
"689",6783,979,490000,0.775,49,815779
"6611",37096,-1729,3810000,0.05,381,816160
"2990",11413,-340.5,3210000,0.6,321,816481
"2992",33738,-420,2360000,0.6,236,816717
"1733",31054,333,6250000,0.65,625,817342
"6329",28844,-1432,1e+06,0.1,100,817442
"6603",17329,-1810,7e+05,0.05,70,817512
"5485",1142,-832,7e+05,0.3,70,817582
"3193",10228,-192,560000,0.6,56,817638
"5979",13742,-1482.5,1500000,0.1,150,817788
"1292",34469,0,2060000,0.65,206,817994
"62",24577,2268,1760000,0.9,176,818170
"1220",14050,77,8e+05,0.65,80,818250
"2184",26148,130,560000,0.65,56,818306
"657",31560,912,1050000,0.775,105,818411
"4876",10939,-977,2450000,0.3,245,818656
"6331",28802,-1432,1050000,0.1,105,818761
"6740",43631,-1582,560000,0.05,56,818817
"3204",10198,-59.5,4470000,0.6,447,819264
"4340",15912,-932,1260000,0.3,126,819390
"6172",42967,-1242,560000,0.1,56,819446
"1937",28722,383,1200000,0.65,120,819566
"4678",12409,-517,720000,0.3,72,819638
"4930",33213,-575.666666666667,5680000,0.3,568,820206
"5248",29447,-810,8e+05,0.3,80,820286
"3649",6975,-56,1200000,0.6,120,820406
"58",22415,2381,1500000,0.9,150,820556
"3192",32930,-300,2050000,0.6,205,820761
"3223",44301,-218,2750000,0.6,275,821036
"4861",33303,-791,1850000,0.3,185,821221
"6028",12839,-1424,7e+05,0.1,70,821291
"4869",10801,-943,1e+06,0.3,100,821391
"5163",8159,-789,630000,0.3,63,821454
"5656",43980,-1384,640000,0.1,64,821518
"3736",28944,-209,1800000,0.6,180,821698
"6344",28437,-1154,1e+06,0.1,100,821798
"4183",37756,-619,1440000,0.3,144,821942
"1437",33267,60,2550000,0.65,255,822197
"4768",11831,-726,1700000,0.3,170,822367
"790",5560,793,490000,0.775,49,822416
"3308",42841,-324,560000,0.6,56,822472
"1753",31110,386,5990000,0.65,599,823071
"3431",9223,-103.666666666667,3330000,0.6,333,823404
"6233",9472,-1364,490000,0.1,49,823453
"5574",38093,-1232,8e+05,0.1,80,823533
"6030",13033,-1028.5,5040000,0.1,504,824037
"5382",40768,-932,490000,0.3,49,824086
"1635",31899,81,4050000,0.65,405,824491
"1227",35651,130,7e+05,0.65,70,824561
"5195",30163,-881,1500000,0.3,150,824711
"3141",10584,-398,4790000,0.6,479,825190
"4050",39419,-23,630000,0.6,63,825253
"3568",7578,-307,2e+06,0.6,200,825453
"4826",11124,-967,490000,0.3,49,825502
"6492",39652,-1388,7e+05,0.1,70,825572
"48",30369,2157,490000,0.9,49,825621
"3940",26245,-420,2920000,0.6,292,825913
"4404",44383,-899,8e+05,0.3,80,825993
"569",42896,786,490000,0.775,49,826042
"4384",15435,-856,1460000,0.3,146,826188
"2002",20950,210,9e+05,0.65,90,826278
"3610",7107,-393,8e+05,0.6,80,826358
"3250",10058,-92,1500000,0.6,150,826508
"832",41457,859.333333333333,4790000,0.775,479,826987
"5352",40915,-504,7e+05,0.3,70,827057
"5020",42876,-919,640000,0.3,64,827121
"1665",31271,385.5,2690000,0.65,269,827390
"1835",6644,479,1e+06,0.65,100,827490
"1754",7606,141.5,1500000,0.65,150,827640
"2204",1903,77,1200000,0.65,120,827760
"6375",28043,-1300,2810000,0.1,281,828041
"1901",42123,38,1360000,0.65,136,828177
"49",29152,2024.5,1050000,0.9,105,828282
"3080",33437,-316,3750000,0.6,375,828657
"801",28272,658,8e+05,0.775,80,828737
"6688",14845,-1657,560000,0.05,56,828793
"2104",3437,418,8e+05,0.65,80,828873
"5468",39873,-528,3760000,0.3,376,829249
"5410",19408,-954,2910000,0.3,291,829540
"347",26076,1009,1340000,0.825,134,829674
"2007",5170,52,630000,0.65,63,829737
"4710",12415,-798,1e+06,0.3,100,829837
"4836",43133,-710,8e+05,0.3,80,829917
"4228",37520,-670,2890000,0.3,289,830206
"2399",18915,-420,1560000,0.6,156,830362
"5065",8911,-725,560000,0.3,56,830418
"1012",25089,776,7e+05,0.775,70,830488
"3706",29561,-167,6820000,0.6,682,831170
"7005",39248,-1550,2360000,0.05,236,831406
"6336",28526,-1300,1190000,0.1,119,831525
"5744",36924,-1266.5,2050000,0.1,205,831730
"5269",5829,-807,8e+05,0.3,80,831810
"6307",30195,-1181,1360000,0.1,136,831946
"5436",1608,-706,560000,0.3,56,832002
"5644",37304,-1448,560000,0.1,56,832058
"4406",15383,-941,490000,0.3,49,832107
"4598",13361,-983,7e+05,0.3,70,832177
"4893",33456,-968,17930000,0.3,1793,833970
"2463",17592,-382,7e+05,0.6,70,834040
"6066",34090,-1440,560000,0.1,56,834096
"3318",32320,-192.5,1500000,0.6,150,834246
"5196",7222,-559,1e+06,0.3,100,834346
"2626",44357,-370,2690000,0.6,269,834615
"1128",17794,340,630000,0.65,63,834678
"278",31121,1445,3850000,0.825,385,835063
"6768",43512,-1903,560000,0.05,56,835119
"2117",4957,490,1260000,0.65,126,835245
"211",34205,1430,3430000,0.825,343,835588
"5207",42314,-556,3250000,0.3,325,835913
"6812",10976,-1925,7e+05,0.05,70,835983
"3566",7800,-337,2410000,0.6,241,836224
"6311",7112,-1178,7e+05,0.1,70,836294
"6906",42324,-1861,7e+05,0.05,70,836364
"4335",23139,-705,1190000,0.3,119,836483
"4018",22149,-484,1530000,0.6,153,836636
"2855",12085,-270,8e+05,0.6,80,836716
"6372",27977,-1057,560000,0.1,56,836772
"4883",33284,-720,1e+06,0.3,100,836872
"5921",36003,-1231,8e+05,0.1,80,836952
"4919",10578,-804,7e+05,0.3,70,837022
"6507",726,-1292,2e+06,0.1,200,837222
"5329",5047,-563,1700000,0.3,170,837392
"1755",7313,129,1290000,0.65,129,837521
"1925",41958,494,7e+05,0.65,70,837591
"2034",27337,398,490000,0.65,49,837640
"668",21244,627,4520000,0.775,452,838092
"5810",15838,-1068,3240000,0.1,324,838416
"5139",8135,-1000,640000,0.3,64,838480
"4889",33273,-964,7e+05,0.3,70,838550
"2206",1891,196,560000,0.65,56,838606
"2418",18164,-178.5,3330000,0.6,333,838939
"6067",11865,-1449,560000,0.1,56,838995
"1084",38713,842,8e+05,0.775,80,839075
"5433",25786,-538,7e+05,0.3,70,839145
"2756",13314,-128,490000,0.6,49,839194
"1152",36432,97,720000,0.65,72,839266
"3639",21176,-463,560000,0.6,56,839322
"1712",30926,34,2900000,0.65,290,839612
"3905",22852,-15,630000,0.6,63,839675
"1805",6852,2.66666666666667,3260000,0.65,326,840001
"5022",32586,-617,1900000,0.3,190,840191
"1661",8840,133.5,1900000,0.65,190,840381
"1557",9787,209,8e+05,0.65,80,840461
"6857",32520,-1968,8e+05,0.05,80,840541
"3316",32448,-239,1190000,0.6,119,840660
"5041",32107,-743,1400000,0.3,140,840800
"1368",11486,56.25,3080000,0.65,308,841108
"6699",14724,-1947,7e+05,0.05,70,841178
"4131",38442,-347.5,1190000,0.6,119,841297
"1395",21495,49,1490000,0.65,149,841446
"2478",17139,-152,7e+05,0.6,70,841516
"5455",1577,-568,1360000,0.3,136,841652
"286",23035,1418,7e+05,0.825,70,841722
"2736",35195,-478,490000,0.6,49,841771
"6065",11914,-1214.5,3600000,0.1,360,842131
"1007",25449,570,4470000,0.775,447,842578
"5535",227,-936,7e+05,0.3,70,842648
"4005",1487,-248,1270000,0.6,127,842775
"3128",10583,-356,8e+05,0.6,80,842855
"5876",14828,-1408,7e+05,0.1,70,842925
"3846",40982,-228.5,5510000,0.6,551,843476
"2604",14759,-120,2050000,0.6,205,843681
"4878",33339,-680,1e+06,0.3,100,843781
"5551",97,-735,7e+05,0.3,70,843851
"5991",35348,-1012,2890000,0.1,289,844140
"3621",21166,-355,490000,0.6,49,844189
"5405",26468,-776,1500000,0.3,150,844339
"2641",43695,-118,630000,0.6,63,844402
"2821",12426,-78,9e+05,0.6,90,844492
"4532",13836,-728,1e+06,0.3,100,844592
"218",21498,1338,2500000,0.825,250,844842
"1182",35965,377,9e+05,0.65,90,844932
"4818",33748,-929,1750000,0.3,175,845107
"5119",31158,-668,490000,0.3,49,845156
"233",32950,1410,630000,0.825,63,845219
"1394",21500,196,2260000,0.65,226,845445
"6766",43541,-1903,7e+05,0.05,70,845515
"1037",24707,859,3300000,0.775,330,845845
"2663",43664,-367,560000,0.6,56,845901
"4742",11924,-927,1690000,0.3,169,846070
"6452",25956,-1190,640000,0.1,64,846134
"161",18540,1005,1120000,0.825,112,846246
"3303",9737,-227,7e+05,0.6,70,846316
"91",10253,1633.5,1190000,0.85,119,846435
"2996",33661,-128,8e+05,0.6,80,846515
"1105",18816,208,1260000,0.65,126,846641
"1469",10255,306,640000,0.65,64,846705
"4167",18494,-766,3450000,0.3,345,847050
"2304",24359,495,2260000,0.65,226,847276
"4528",35676,-599.5,2390000,0.3,239,847515
"5511",24257,-908,490000,0.3,49,847564
"6665",15339,-1744,8e+05,0.05,80,847644
"4496",35844,-635,1680000,0.3,168,847812
"3495",42462,-63,2500000,0.6,250,848062
"5588",18389,-1233,1820000,0.1,182,848244
"2084",26758,175,560000,0.65,56,848300
"4718",12205,-773,1700000,0.3,170,848470
"4720",34188,-907,8e+05,0.3,80,848550
"117",7600,1584,3100000,0.85,310,848860
"5519",24114,-522,8e+05,0.3,80,848940
"849",27246,574,7e+05,0.775,70,849010
"794",41623,879,1050000,0.775,105,849115
"2228",1664,376,1260000,0.65,126,849241
"3675",29614,-236,3140000,0.6,314,849555
"3687",6633,-67.6666666666667,2050000,0.6,205,849760
"1606",32030,270.666666666667,2030000,0.65,203,849963
"122",7135,1647,490000,0.85,49,850012
"6901",7851,-1791,7e+05,0.05,70,850082
"5330",27916,-860.5,5160000,0.3,516,850598
"4774",34139,-945,6750000,0.3,675,851273
"5350",40973,-728,8e+05,0.3,80,851353
"3254",10087,-452,2060000,0.6,206,851559
"3414",31676,-298,4490000,0.6,449,852008
"2716",35377,-163,7e+05,0.6,70,852078
"6825",10955,-1637,3690000,0.05,369,852447
"5471",25428,-565,3060000,0.3,306,852753
"3453",8654,-178,2060000,0.6,206,852959
"1327",43339,452,1350000,0.65,135,853094
"5544",197,-583,1700000,0.3,170,853264
"3073",33268,-346.5,2450000,0.6,245,853509
"1524",10076,206,3620000,0.65,362,853871
"2114",3381,361,720000,0.65,72,853943
"85",34060,1557,1360000,0.85,136,854079
"2610",14663,-484,560000,0.6,56,854135
"1620",42757,147,5050000,0.65,505,854640
"481",13408,627,2260000,0.775,226,854866
"5847",15317,-1265,1490000,0.1,149,855015
"3283",32746,-291,4160000,0.6,416,855431
"5786",44409,-1371.5,1290000,0.1,129,855560
"5878",36239,-1485,1500000,0.1,150,855710
"5942",35887,-1075.66666666667,5350000,0.1,535,856245
"2656",14236,-291,560000,0.6,56,856301
"2651",14261,-134,8e+05,0.6,80,856381
"6003",13293,-1257,1500000,0.1,150,856531
"5266",6117,-923,8e+05,0.3,80,856611
"2444",17832,-409,1360000,0.6,136,856747
"2813",12447,-399,1460000,0.6,146,856893
"4223",37349,-603.5,2600000,0.3,260,857153
"3681",44284,-268,1050000,0.6,105,857258
"6832",42974,-1851,560000,0.05,56,857314
"3153",10332,-14,9e+05,0.6,90,857404
"6534",38251,-1504.66666666667,5210000,0.05,521,857925
"5948",14262,-1202,4350000,0.1,435,858360
"3151",10301,-415,640000,0.6,64,858424
"4722",12175,-850,1190000,0.3,119,858543
"6798",34103,-1833,560000,0.05,56,858599
"6720",14847,-1873,2550000,0.05,255,858854
"2798",34881,-401,560000,0.6,56,858910
"5368",27078,-670,2e+06,0.3,200,859110
"5236",29144,-962,490000,0.3,49,859159
"2550",15517,-469,1920000,0.6,192,859351
"1697",8082,234,1350000,0.65,135,859486
"4280",37094,-959,2360000,0.3,236,859722
"3008",11225,-480.5,2850000,0.6,285,860007
"2153",40697,248,20040000,0.65,2004,862011
"2907",11691,-225,720000,0.6,72,862083
"1314",43324,448,8e+05,0.65,80,862163
"3366",8956,-264,8e+05,0.6,80,862243
"6367",28047,-1365,560000,0.1,56,862299
"3527",8056,-339,1700000,0.6,170,862469
"102",32416,1663,4690000,0.85,469,862938
"5731",36926,-1312,8e+05,0.1,80,863018
"5706",37020,-1019,560000,0.1,56,863074
"2327",24262,477,1610000,0.65,161,863235
"3657",6688,-21,560000,0.6,56,863291
"3138",10570,-282,2690000,0.6,269,863560
"1239",13887,432.5,1600000,0.65,160,863720
"522",33781,745,1120000,0.775,112,863832
"5001",32814,-724,560000,0.3,56,863888
"4551",23799,-589,2960000,0.3,296,864184
"6064",21561,-1139,7e+05,0.1,70,864254
"500",34149,988.5,2160000,0.775,216,864470
"235",33086,1443,3180000,0.825,318,864788
"4108",24026,-312,8e+05,0.6,80,864868
"4739",34204,-941,1200000,0.3,120,864988
"4648",12555,-907,8e+05,0.3,80,865068
"3700",29002,-364,1500000,0.6,150,865218
"6561",18077,-1577,7e+05,0.05,70,865288
"6564",37717,-1544,3200000,0.05,320,865608
"5072",31775,-515,1260000,0.3,126,865734
"1063",654,960,1e+06,0.775,100,865834
"3064",10868,-420,1700000,0.6,170,866004
"708",6850,686,490000,0.775,49,866053
"6110",11261,-1217,7e+05,0.1,70,866123
"5108",8666,-989,560000,0.3,56,866179
"3420",8659,-419,7e+05,0.6,70,866249
"5214",6984,-534.666666666667,1850000,0.3,185,866434
"6987",39946,-1787,490000,0.05,49,866483
"6118",21521,-1216,6140000,0.1,614,867097
"3959",26199,-451,1920000,0.6,192,867289
"1444",42988,222,1e+06,0.65,100,867389
"5961",35660,-1115,2960000,0.1,296,867685
"4414",36442,-577,1690000,0.3,169,867854
"106",8786,1588,8e+05,0.85,80,867934
"3438",31315,-419,1500000,0.6,150,868084
"225",33200,1105,1960000,0.825,196,868280
"702",6508,752,7e+05,0.775,70,868350
"6285",8104,-1315,9e+05,0.1,90,868440
"5267",42083,-697,5090000,0.3,509,868949
"3444",8612,-100.5,1290000,0.6,129,869078
"5841",36364,-1064,1190000,0.1,119,869197
"440",36052,852,8e+05,0.775,80,869277
"3840",40950,-252,7e+05,0.6,70,869347
"6790",34046,-1997,1990000,0.05,199,869546
"6742",35615,-1692,7e+05,0.05,70,869616
"4829",21474,-753,7e+05,0.3,70,869686
"985",25923,868,1e+06,0.775,100,869786
"3069",33474,-52,1500000,0.6,150,869936
"4345",23104,-835,490000,0.3,49,869985
"5056",32182,-832,1120000,0.3,112,870097
"4075",593,-108,1400000,0.6,140,870237
"3317",32261,-239,560000,0.6,56,870293
"644",31467,959,2310000,0.775,231,870524
"6481",23487,-1112,560000,0.1,56,870580
"3076",10717,-359,1500000,0.6,150,870730
"4705",34353,-709,7e+05,0.3,70,870800
"5004",32785,-682,8e+05,0.3,80,870880
"7060",18529,-2614,8e+05,0.001,80,870960
"443",14331,775,1950000,0.775,195,871155
"1466",10631,378,640000,0.65,64,871219
"4480",36056,-948,1190000,0.3,119,871338
"2903",11779,-234,9e+05,0.6,90,871428
"5816",36593,-1270,630000,0.1,63,871491
"5986",13838,-1374,4190000,0.1,419,871910
"3184",10285,-266,640000,0.6,64,871974
"4761",11725,-632,2690000,0.3,269,872243
"5135",8162,-588,640000,0.3,64,872307
"4717",34327,-664.5,2200000,0.3,220,872527
"4001",25760,-224,1890000,0.6,189,872716
"5395",3201,-899,8e+05,0.3,80,872796
"1387",33667,115.5,3190000,0.65,319,873115
"5654",17731,-1454,560000,0.1,56,873171
"2126",26421,448.5,1990000,0.65,199,873370
"4638",23759,-849,560000,0.3,56,873426
"3007",33706,-307.5,9360000,0.6,936,874362
"2895",11989,-96,1440000,0.6,144,874506
"1787",30100,114,2400000,0.65,240,874746
"1441",42999,96,1190000,0.65,119,874865
"2207",1818,87,1340000,0.65,134,874999
"2559",15407,-422.5,2360000,0.6,236,875235
"5906",14796,-1415,560000,0.1,56,875291
"1303",43333,448,7e+05,0.65,70,875361
"2273",25334,208,1e+06,0.65,100,875461
"5088",23729,-506,490000,0.3,49,875510
"68",35874,1751,1500000,0.85,150,875660
"1518",32748,352,2500000,0.65,250,875910
"1879",6215,59,490000,0.65,49,875959
"1179",36111,46,720000,0.65,72,876031
"3749",5934,-328,8e+05,0.6,80,876111
"3762",5751,-208.25,2980000,0.6,298,876409
"2826",12445,-491.5,1120000,0.6,112,876521
"5209",7202,-819,2690000,0.3,269,876790
"6070",11954,-1331,2260000,0.1,226,877016
"5666",17456,-1133,8e+05,0.1,80,877096
"4877",33422,-982,4650000,0.3,465,877561
"2922",11682,-227,2890000,0.6,289,877850
"1997",5282,396.333333333333,2620000,0.65,262,878112
"4107",38772,-380,5350000,0.6,535,878647
"5318",41289,-623,1530000,0.3,153,878800
"4256",37171,-952,7e+05,0.3,70,878870
"1290",12048,72,8e+05,0.65,80,878950
"3051",11007,-324,2240000,0.6,224,879174
"3982",26029,-285,1690000,0.6,169,879343
"2681",35656,-44,490000,0.6,49,879392
"3341",32185,-490,490000,0.6,49,879441
"6519",23942,-1190,490000,0.1,49,879490
"727",29017,653,4390000,0.775,439,879929
"4967",10480,-546,3600000,0.3,360,880289
"4266",37031,-856,7e+05,0.3,70,880359
"224",21429,1214,1920000,0.825,192,880551
"5188",7489,-720,1050000,0.3,105,880656
"1285",12321,83,1960000,0.65,196,880852
"3337",32220,-384,1260000,0.6,126,880978
"1924",42001,165,8e+05,0.65,80,881058
"2787",43505,-128,1640000,0.6,164,881222
"4312",36874,-672,490000,0.3,49,881271
"4220",37396,-927.5,1720000,0.3,172,881443
"3131",44314,-189,1e+06,0.6,100,881543
"5965",35516,-1054,8e+05,0.1,80,881623
"1216",35784,81,6310000,0.65,631,882254
"3271",32662,-19.6666666666667,1920000,0.6,192,882446
"4455",14628,-701,490000,0.3,49,882495
"1563",32462,454,1560000,0.65,156,882651
"2064",40777,107,560000,0.65,56,882707
"4310",16669,-967,630000,0.3,63,882770
"4961",10327,-629.5,1290000,0.3,129,882899
"2708",35478,-319,1e+06,0.6,100,882999
"4816",33695,-703.5,2e+06,0.3,200,883199
"1145",16168,66,2060000,0.65,206,883405
"2244",39826,4,2160000,0.65,216,883621
"542",33309,705,1e+06,0.775,100,883721
"1409",33408,407,560000,0.65,56,883777
"2488",37041,-76,7e+05,0.6,70,883847
"4254",17465,-636,2060000,0.3,206,884053
"4433",14964,-638.5,2190000,0.3,219,884272
"4714",12007,-687,8e+05,0.3,80,884352
"5021",32626,-694,1500000,0.3,150,884502
"5336",4813,-620,7e+05,0.3,70,884572
"1898",6077,302,490000,0.65,49,884621
"4953",10299,-853,1290000,0.3,129,884750
"1537",10095,473,1050000,0.65,105,884855
"5033",32257,-627,490000,0.3,49,884904
"5161",8033,-593.5,1280000,0.3,128,885032
"4118",23949,-314,7e+05,0.6,70,885102
"5734",16836,-1402,1700000,0.1,170,885272
"3576",7764,-419,1400000,0.6,140,885412
"1496",32878,56,7e+05,0.65,70,885482
"2755",35249,-128,560000,0.6,56,885538
"1613",31850,33,1800000,0.65,180,885718
"143",23470,1674,1e+06,0.85,100,885818
"3226",42897,-139,8e+05,0.6,80,885898
"130",41887,1775,2360000,0.85,236,886134
"5457",25557,-895,560000,0.3,56,886190
"3547",30700,-25,2340000,0.6,234,886424
"1022",25043,945,8e+05,0.775,80,886504
"1380",11596,101,1890000,0.65,189,886693
"4736",11841,-947,640000,0.3,64,886757
"133",28175,1696,8e+05,0.85,80,886837
"6668",15384,-1819,2490000,0.05,249,887086
"4524",14036,-514.333333333333,1960000,0.3,196,887282
"3022",33506,-466,1e+06,0.6,100,887382
"6630",16989,-1637,5610000,0.05,561,887943
"1667",31734,396,2660000,0.65,266,888209
"6449",26086,-1358,8e+05,0.1,80,888289
"5575",18399,-1042,8e+05,0.1,80,888369
"5682",17363,-1257,7e+05,0.1,70,888439
"2680",13956,-281,560000,0.6,56,888495
"6368",28135,-1063,9e+05,0.1,90,888585
"585",32689,788.5,1820000,0.775,182,888767
"2455",37225,-443,7e+05,0.6,70,888837
"25",43589,2403,1190000,0.9,119,888956
"5118",8327,-731,560000,0.3,56,889012
"5861",15220,-1408,1190000,0.1,119,889131
"4495",35782,-546,490000,0.3,49,889180
"6252",8906,-1164,1850000,0.1,185,889365
"3020",11057,-61.5,1600000,0.6,160,889525
"2440",37527,-154,720000,0.6,72,889597
"6807",11165,-1883,560000,0.05,56,889653
"4246",37310,-525,7330000,0.3,733,890386
"5197",7508,-652,1190000,0.3,119,890505
"5126",31223,-543,640000,0.3,64,890569
"105",42611,1717,2790000,0.85,279,890848
"5496",39472,-577,560000,0.3,56,890904
"4156",18422,-739.333333333333,6930000,0.3,693,891597
"1263",12731,140,2960000,0.65,296,891893
"2639",14406,-413,630000,0.6,63,891956
"1555",42885,426,8e+05,0.65,80,892036
"4194",37688,-886,1260000,0.3,126,892162
"4161",37976,-652,2700000,0.3,270,892432
"4540",14027,-540,2380000,0.3,238,892670
"978",1852,572,7e+05,0.775,70,892740
"6598",17490,-1853,1700000,0.05,170,892910
"1945",41812,1,2130000,0.65,213,893123
"2460",37202,-443,490000,0.6,49,893172
"3088",33305,-447,490000,0.6,49,893221
"3148",10486,-52,640000,0.6,64,893285
"464",13643,559,1e+06,0.775,100,893385
"2022",4915,154,8e+05,0.65,80,893465
"6294",30545,-1067,490000,0.1,49,893514
"4182",18046,-873,2090000,0.3,209,893723
"2453",37196,-177,640000,0.6,64,893787
"6059",34382,-1232,4410000,0.1,441,894228
"3070",33381,-283,1190000,0.6,119,894347
"5229",42178,-626,2750000,0.3,275,894622
"2838",43356,-411,2120000,0.6,212,894834
"1494",32915,283,1700000,0.65,170,895004
"4834",10993,-946,8e+05,0.3,80,895084
"6293",30855,-1190,2060000,0.1,206,895290
"6401",4422,-1085,560000,0.1,56,895346
"377",23441,1054,1e+06,0.825,100,895446
"5194",30471,-953,2190000,0.3,219,895665
"1111",38131,96,2800000,0.65,280,895945
"3732",6014,-134.5,1260000,0.6,126,896071
"704",29320,934,7e+05,0.775,70,896141
"4596",13461,-509,7e+05,0.3,70,896211
"2430",44098,-121,1e+06,0.6,100,896311
"4775",34034,-622,1440000,0.3,144,896455
"5750",16729,-1271,2190000,0.1,219,896674
"4012",25550,-116,2410000,0.6,241,896915
"1502",10165,367,490000,0.65,49,896964
"3535",8057,-379,1700000,0.6,170,897134
"1593",42750,99,5800000,0.65,580,897714
"663",21272,627,8e+05,0.775,80,897794
"6084",34003,-1169,1360000,0.1,136,897930
"3758",42002,-239,1050000,0.6,105,898035
"5030",32614,-552,3060000,0.3,306,898341
"5120",8547,-744,560000,0.3,56,898397
"5487",980,-655,2850000,0.3,285,898682
"4957",33108,-550,1700000,0.3,170,898852
"6147",33414,-1002,7e+05,0.1,70,898922
"2267",25316,52,1360000,0.65,136,899058
"6384",41208,-1417,1360000,0.1,136,899194
"518",11367,671,490000,0.775,49,899243
"4421",36702,-889,7960000,0.3,796,900039
"2239",25588,470,2250000,0.65,225,900264
"1910",42006,15,490000,0.65,49,900313
"1889",44294,317,5660000,0.65,566,900879
"620",9314,645,3300000,0.775,330,901209
"4827",11228,-849,7e+05,0.3,70,901279
"2049",40841,62,1e+06,0.65,100,901379
"3842",4704,-286,2760000,0.6,276,901655
"4754",11710,-693.5,1270000,0.3,127,901782
"4979",32910,-944,3900000,0.3,390,902172
"4257",17314,-533,490000,0.3,49,902221
"2454",17531,-27,640000,0.6,64,902285
"2661",14267,-337,2690000,0.6,269,902554
"6166",43026,-1013,7e+05,0.1,70,902624
"2471",37154,-452,630000,0.6,63,902687
"6165",33295,-1251,1050000,0.1,105,902792
"1774",30220,377,6540000,0.65,654,903446
"5932",14266,-1057.5,3200000,0.1,320,903766
"5498",1010,-646,3260000,0.3,326,904092
"846",4691,574,7e+05,0.775,70,904162
"1429",10625,262,7e+05,0.65,70,904232
"1948",42060,381.5,4900000,0.65,490,904722
"2283",24516,423,1500000,0.65,150,904872
"2115",22915,489,2890000,0.65,289,905161
"4864",33310,-827,1e+06,0.3,100,905261
"5325",27858,-835,8e+05,0.3,80,905341
"489",34512,917,2e+06,0.775,200,905541
"3463",8616,-372,560000,0.6,56,905597
"5507",629,-908,1260000,0.3,126,905723
"6928",29139,-1554,8e+05,0.05,80,905803
"1682",31411,323,560000,0.65,56,905859
"4994",32870,-992,7e+05,0.3,70,905929
"4575",13559,-927,490000,0.3,49,905978
"6535",18765,-1693.66666666667,1850000,0.05,185,906163
"5080",31635,-578,1700000,0.3,170,906333
"4798",11161,-928,490000,0.3,49,906382
"2160",40430,461,720000,0.65,72,906454
"4796",33754,-558,560000,0.3,56,906510
"4920",33169,-606,7e+05,0.3,70,906580
"571",10175,969,1e+06,0.775,100,906680
"5570",38293,-1093.5,4490000,0.1,449,907129
"4338",36759,-629,7e+05,0.3,70,907199
"5321",5143,-909,560000,0.3,56,907255
"747",28919,729,7e+05,0.775,70,907325
"5543",219,-633,1190000,0.3,119,907444
"3778",28492,-402,1260000,0.6,126,907570
"4633",43545,-585,3740000,0.3,374,907944
"6254",8885,-1391,560000,0.1,56,908000
"1553",42837,358,8e+05,0.65,80,908080
"2635",36082,-320,720000,0.6,72,908152
"1844",42179,464,1e+06,0.65,100,908252
"2035",27176,460,560000,0.65,56,908308
"3774",5691,-430.666666666667,2470000,0.6,247,908555
"5458",39860,-947,3450000,0.3,345,908900
"5016",32639,-504,8e+05,0.3,80,908980
"4471",14430,-933.5,1430000,0.3,143,909123
"5130",31030,-671,8e+05,0.3,80,909203
"1903",42126,242,4e+06,0.65,400,909603
"5787",36650,-1208,8e+05,0.1,80,909683
"5715",17065,-1187,3950000,0.1,395,910078
"4120",235,-314,490000,0.6,49,910127
"4999",10207,-608,2400000,0.3,240,910367
"4027",24821,-333,490000,0.6,49,910416
"3516",30837,-159,4510000,0.6,451,910867
"3924",40527,-107,560000,0.6,56,910923
"5926",35967,-1327.5,2400000,0.1,240,911163
"2904",21549,-234,630000,0.6,63,911226
"1809",6816,421,8e+05,0.65,80,911306
"5235",6637,-850,7e+05,0.3,70,911376
"5594",37998,-1435,1700000,0.1,170,911546
"6990",25729,-1924,560000,0.05,56,911602
"4785",11445,-899,630000,0.3,63,911665
"3698",28971,-412,490000,0.6,49,911714
"5253",42067,-827,1e+06,0.3,100,911814
"5673",37189,-1120,1890000,0.1,189,912003
"4802",11351,-660.5,4250000,0.3,425,912428
"5366",4184,-785,8e+05,0.3,80,912508
"3276",9906,-346,490000,0.6,49,912557
"5160",30780,-628,560000,0.3,56,912613
"5597",38004,-1033,8e+05,0.1,80,912693
"4184",18048,-608,8e+05,0.3,80,912773
"1821",29678,400,3190000,0.65,319,913092
"3248",10057,-333,1e+06,0.6,100,913192
"6142",10910,-1353.5,1260000,0.1,126,913318
"4355",15665,-931,1e+06,0.3,100,913418
"6197",33143,-1266,2340000,0.1,234,913652
"6027",13015,-1373,1e+06,0.1,100,913752
"3960",40177,-144,8e+05,0.6,80,913832
"6149",10752,-1039,1400000,0.1,140,913972
"5585",18392,-1435,1190000,0.1,119,914091
"5383",26898,-627,2960000,0.3,296,914387
"5804",36668,-1382,720000,0.1,72,914459
"4092",24089,-156,1e+06,0.6,100,914559
"1250",13520,461,560000,0.65,56,914615
"3144",10457,-200,560000,0.6,56,914671
"1476",10300,78,1920000,0.65,192,914863
"1917",5996,30,1500000,0.65,150,915013
"5807",36548,-1103,560000,0.1,56,915069
"1244",43602,360,1190000,0.65,119,915188
"1971",5457,220,490000,0.65,49,915237
"4642",35032,-550,7e+05,0.3,70,915307
"4176",38149,-835,7140000,0.3,714,916021
"3746",28839,-209,640000,0.6,64,916085
"1499",32869,57,7e+05,0.65,70,916155
"5183",30482,-806,490000,0.3,49,916204
"5595",38019,-1157,1700000,0.1,170,916374
"4394",15379,-627,1640000,0.3,164,916538
"4478",14289,-627,640000,0.3,64,916602
"5008",10018,-774.5,1260000,0.3,126,916728
"4150",38121,-998,8e+05,0.3,80,916808
"4486",14372,-546,640000,0.3,64,916872
"3611",29872,-51,7e+05,0.6,70,916942
"1114",18301,312,490000,0.65,49,916991
"1914",28923,466,2190000,0.65,219,917210
"6015",13240,-1376,560000,0.1,56,917266
"5252",29093,-827,1190000,0.3,119,917385
"6029",13167,-1162,1700000,0.1,170,917555
"1442",42986,148,3110000,0.65,311,917866
"3622",21168,-355,7e+05,0.6,70,917936
"4370",15504,-951.5,1460000,0.3,146,918082
"5492",1018,-596,490000,0.3,49,918131
"2629",36159,-291,1450000,0.6,145,918276
"3045",43090,-16,8e+05,0.6,80,918356
"1189",14291,150,720000,0.65,72,918428
"5607",37920,-1267.5,4060000,0.1,406,918834
"2959",33840,-420,1750000,0.6,175,919009
"5308",28169,-780,560000,0.3,56,919065
"3137",10493,-274.333333333333,2790000,0.6,279,919344
"6536",38178,-1501,7e+05,0.05,70,919414
"2757",35101,-404,560000,0.6,56,919470
"3512",8332,-487,2330000,0.6,233,919703
"5096",8767,-874,7e+05,0.3,70,919773
"2179",40254,430,490000,0.65,49,919822
"3662",42202,-17,2550000,0.6,255,920077
"4750",11794,-662.5,1330000,0.3,133,920210
"3953",2180,-101,560000,0.6,56,920266
"5989",35340,-1094,1850000,0.1,185,920451
"1962",5583,259,1360000,0.65,136,920587
"4436",14821,-710,1e+06,0.3,100,920687
"5859",15171,-1209,1190000,0.1,119,920806
"5760",16763,-1054,2400000,0.1,240,921046
"330",22863,1027,8e+05,0.825,80,921126
"5746",16936,-1044,560000,0.1,56,921182
"2595",14791,-61,490000,0.6,49,921231
"5494",24389,-505,640000,0.3,64,921295
"5067",31811,-703,2460000,0.3,246,921541
"1478",10232,159.5,2820000,0.65,282,921823
"6681",36343,-1790,1800000,0.05,180,922003
"2774",43502,-142,560000,0.6,56,922059
"1505",32934,378,4880000,0.65,488,922547
"5414",26154,-809,1850000,0.3,185,922732
"5226",6894,-520,1e+06,0.3,100,922832
"5794",16159,-1307,2620000,0.1,262,923094
"7009",121,-1637,490000,0.05,49,923143
"726",21114,940,3810000,0.775,381,923524
"1854",42199,89,3060000,0.65,306,923830
"4641",12924,-542,7e+05,0.3,70,923900
"5824",23858,-1015,2260000,0.1,226,924126
"4181",18115,-886,1e+06,0.3,100,924226
"1640",8874,258.333333333333,2530000,0.65,253,924479
"6187",42956,-1434,1e+06,0.1,100,924579
"5142",23704,-744,630000,0.3,63,924642
"1183",14414,377,630000,0.65,63,924705
"6040",12789,-1293,720000,0.1,72,924777
"5261",28825,-927,7e+05,0.3,70,924847
"6448",19010,-1231,7e+05,0.1,70,924917
"5122",8450,-964,560000,0.3,56,924973
"3410",42648,-160,560000,0.6,56,925029
"4444",14850,-947,1700000,0.3,170,925199
"6486",1141,-1388,1e+06,0.1,100,925299
"4811",11212,-874,2060000,0.3,206,925505
"4381",15497,-956,9e+05,0.3,90,925595
"5772",36799,-1019,1050000,0.1,105,925700
"3520",8075,-434,2340000,0.6,234,925934
"4908",10679,-539,490000,0.3,49,925983
"895",26507,706,560000,0.775,56,926039
"4341",36678,-758,560000,0.3,56,926095
"479",43534,814,7e+05,0.775,70,926165
"6207",10181,-1186,8e+05,0.1,80,926245
"5136",8158,-588,1360000,0.3,136,926381
"2511",16818,-62,1050000,0.6,105,926486
"2662",43673,-292,1190000,0.6,119,926605
"5169",30694,-728,810000,0.3,81,926686
"6385",41011,-1409,1e+06,0.1,100,926786
"3760",44263,-305,3780000,0.6,378,927164
"531",33666,919,1750000,0.775,175,927339
"2128",26408,385,1050000,0.65,105,927444
"1104",38468,915,1190000,0.775,119,927563
"127",6136,1950,1190000,0.85,119,927682
"1617",32017,378,2e+06,0.65,200,927882
"4339",36766,-863,490000,0.3,49,927931
"4534",21643,-585,1e+06,0.3,100,928031
"4624",35396,-993,5160000,0.3,516,928547
"5655",17563,-1387.5,2340000,0.1,234,928781
"2645",44328,-497,630000,0.6,63,928844
"3783",41676,-466.5,3960000,0.6,396,929240
"3586",30113,-497,7e+05,0.6,70,929310
"3365",8951,-264,7e+05,0.6,70,929380
"4784",33915,-558,1260000,0.3,126,929506
"5341",5025,-764,560000,0.3,56,929562
"4219",37689,-804,3450000,0.3,345,929907
"4987",10088,-634,2500000,0.3,250,930157
"5934",14163,-1345,1e+06,0.1,100,930257
"3912",19674,-356,1190000,0.6,119,930376
"5340",41105,-673,7e+05,0.3,70,930446
"6746",35623,-1547,1190000,0.05,119,930565
"3814",20929,-316,8e+05,0.6,80,930645
"4523",35693,-574,3390000,0.3,339,930984
"3347",9273,-261,1120000,0.6,112,931096
"5900",36113,-1059,640000,0.1,64,931160
"2393",38209,-233,1560000,0.6,156,931316
"4171",18174,-894,8e+05,0.3,80,931396
"1834",6755,324,9e+05,0.65,90,931486
"292",6493,1310,8e+05,0.825,80,931566
"6321",29446,-1280,1360000,0.1,136,931702
"1208",14041,212,7e+05,0.65,70,931772
"3543",30710,-106,1700000,0.6,170,931942
"2579",43843,-271,2380000,0.6,238,932180
"4165",37862,-802,2190000,0.3,219,932399
"5925",14297,-1413,640000,0.1,64,932463
"6429",19694,-1218,2050000,0.1,205,932668
"4247",17556,-981,2260000,0.3,226,932894
"4563",13796,-747,1620000,0.3,162,933056
"5910",14417,-1022.5,1600000,0.1,160,933216
"2397",18589,-490,5030000,0.6,503,933719
"4210",37401,-970,560000,0.3,56,933775
"4351",15860,-762,8e+05,0.3,80,933855
"4569",35341,-731,1500000,0.3,150,934005
"1968",5558,225,490000,0.65,49,934054
"6116",11406,-1114.5,2190000,0.1,219,934273
"4148",38166,-697,1e+06,0.3,100,934373
"5263",29192,-530,6900000,0.3,690,935063
"1672",31402,342,1680000,0.65,168,935231
"4468",36078,-617.5,9070000,0.3,907,936138
"2089",26788,187,980000,0.65,98,936236
"4191",37789,-571,1990000,0.3,199,936435
"3385",8841,-276,490000,0.6,49,936484
"5785",43880,-1497,7e+05,0.1,70,936554
"6453",26224,-1278,13720000,0.1,1372,937926
"6310",29816,-1303,7e+05,0.1,70,937996
"3505",7976,-225,1500000,0.6,150,938146
"1430",10540,225,1190000,0.65,119,938265
"2419",18304,-313,1890000,0.6,189,938454
"6646",44471,-1836,1700000,0.05,170,938624
"2693",13802,-6,490000,0.6,49,938673
"6753",13883,-1676,1490000,0.05,149,938822
"4130",38483,-412,490000,0.6,49,938871
"6408",40786,-1297,1190000,0.1,119,938990
"5262",6099,-525,8e+05,0.3,80,939070
"4879",33265,-714,1560000,0.3,156,939226
"1590",42800,461,1610000,0.65,161,939387
"5955",43651,-1301,7e+05,0.1,70,939457
"836",27678,796,8e+05,0.775,80,939537
"1860",29452,324,3200000,0.65,320,939857
"3962",26193,-210,4740000,0.6,474,940331
"3000",21499,-351,1190000,0.6,119,940450
"5963",13837,-1104.42857142857,9230000,0.1,923,941373
"4227",17781,-507,1360000,0.3,136,941509
"1302",34247,313,7e+05,0.65,70,941579
"5140",8210,-1000,1280000,0.3,128,941707
"1547",9757,194,7e+05,0.65,70,941777
"5495",24497,-505,2e+06,0.3,200,941977
"15",39985,2703,490000,0.925,49,942026
"6050",34486,-1028,2140000,0.1,214,942240
"3116",10577,-87.5,980000,0.6,98,942338
"1443",33168,153,1500000,0.65,150,942488
"3966",26101,-275.5,2960000,0.6,296,942784
"2158",40424,168,630000,0.65,63,942847
"3956",26290,-103,9200000,0.6,920,943767
"6117",11286,-1246,1e+06,0.1,100,943867
"5047",9793,-920,490000,0.3,49,943916
"4313",16887,-832,3760000,0.3,376,944292
"5107",23703,-898,1290000,0.3,129,944421
"6202",33111,-1170,2700000,0.1,270,944691
"3398",31808,-126,3110000,0.6,311,945002
"4804",11571,-614.5,1500000,0.3,150,945152
"4305",16863,-877,1050000,0.3,105,945257
"4588",13524,-780,2260000,0.3,226,945483
"3624",7171,-393,1990000,0.6,199,945682
"4954",33032,-819.5,2440000,0.3,244,945926
"6615",17089,-1893,8e+05,0.05,80,946006
"4426",15214,-556,1190000,0.3,119,946125
"1864",29247,338,490000,0.65,49,946174
"642",8755,690.5,1490000,0.775,149,946323
"30",32893,2133,32320000,0.9,3232,949555
"4449",36178,-937,2360000,0.3,236,949791
"5418",1985,-685,7e+05,0.3,70,949861
"3917",26280,-23,630000,0.6,63,949924
"5265",5908,-923,1e+06,0.3,100,950024
"1234",35528,50,7e+05,0.65,70,950094
"6451",1843,-1190,8e+05,0.1,80,950174
"6126",11118,-1426,1750000,0.1,175,950349
"844",27335,610,1e+06,0.775,100,950449
"4716",12034,-904,1700000,0.3,170,950619
"2217",25983,357,1360000,0.65,136,950755
"3358",32193,-1,7e+05,0.6,70,950825
"3244",10012,-190,630000,0.6,63,950888
"4764",11695,-591,8e+05,0.3,80,950968
"5633",18086,-1146,3550000,0.1,355,951323
"3113",33212,-134,1260000,0.6,126,951449
"5776",16117,-1070,1190000,0.1,119,951568
"6822",10718,-1845,560000,0.05,56,951624
"6096",43183,-1484,1400000,0.1,140,951764
"2969",33792,-118,1260000,0.6,126,951890
"4706",12161,-719,2630000,0.3,263,952153
"6087",21537,-1216,560000,0.1,56,952209
"5331",41159,-620,1050000,0.3,105,952314
"5916",14781,-1248,2750000,0.1,275,952589
"4604",35047,-792,7190000,0.3,719,953308
"2152",19511,143,2180000,0.65,218,953526
"5365",40881,-611,3800000,0.3,380,953906
"4777",33927,-726,1e+06,0.3,100,954006
"6693",36280,-1873,7e+05,0.05,70,954076
"4931",10406,-546,1290000,0.3,129,954205
"5464",1419,-565,560000,0.3,56,954261
"3477",31044,-237,3290000,0.6,329,954590
"2578",43807,-271,560000,0.6,56,954646
"6404",4239,-1307,2060000,0.1,206,954852
"5474",1304,-919,560000,0.3,56,954908
"3101",10760,-492,7e+05,0.6,70,954978
"3237",10060,-452,490000,0.6,49,955027
"4283",17120,-968.5,1500000,0.3,150,955177
"5565",18818,-1243,1050000,0.1,105,955282
"6181",33179,-1179,7e+05,0.1,70,955352
"870",26998,835,7e+05,0.775,70,955422
"4873",10732,-560,8e+05,0.3,80,955502
"4542",14031,-890,2060000,0.3,206,955708
"4639",12968,-775,3700000,0.3,370,956078
"5670",17418,-1307,7e+05,0.1,70,956148
"552",33053,599,560000,0.775,56,956204
"6495",963,-1292,560000,0.1,56,956260
"4696",12188,-894,560000,0.3,56,956316
"5556",38434,-670,560000,0.3,56,956372
"6323",6302,-1238,1260000,0.1,126,956498
"4559",35464,-713,560000,0.3,56,956554
"2350",24127,55,560000,0.65,56,956610
"515",11422,773.25,6020000,0.775,602,957212
"2382",38621,284,4080000,0.65,408,957620
"6051",34453,-1243,1700000,0.1,170,957790
"4209",37647,-804,1690000,0.3,169,957959
"6353",5650,-1026,3620000,0.1,362,958321
"4603",35080,-842.333333333333,1960000,0.3,196,958517
"5943",44320,-1240,8e+05,0.1,80,958597
"814",28067,741,560000,0.775,56,958653
"6414",20173,-1117,490000,0.1,49,958702
"4388",15511,-895.333333333333,3380000,0.3,338,959040
"4179",37781,-894,2190000,0.3,219,959259
"3988",1907,-131,1200000,0.6,120,959379
"5788",16434,-1238,2400000,0.1,240,959619
"1832",42182,174,8e+05,0.65,80,959699
"5643",17594,-1034,630000,0.1,63,959762
"981",40053,711,1050000,0.775,105,959867
"6394",27466,-1193,4250000,0.1,425,960292
"4962",10403,-868,2160000,0.3,216,960508
"5848",15251,-1106,1400000,0.1,140,960648
"4866",10772,-748,1e+06,0.3,100,960748
"3468",31067,-301,560000,0.6,56,960804
"2387",38318,-13,8e+05,0.6,80,960884
"4434",14999,-532,630000,0.3,63,960947
"612",21336,951,980000,0.775,98,961045
"5392",3200,-737,1440000,0.3,144,961189
"6932",42068,-1852,4750000,0.05,475,961664
"3562",30452,-168,1260000,0.6,126,961790
"1807",29720,43,640000,0.65,64,961854
"5099",8744,-661,1e+06,0.3,100,961954
"3176",10322,-196,1360000,0.6,136,962090
"1390",33878,70,1920000,0.65,192,962282
"5344",41037,-792,560000,0.3,56,962338
"5907",14692,-1415,1200000,0.1,120,962458
"4452",36177,-976,5440000,0.3,544,963002
"4061",39052,-300,560000,0.6,56,963058
"6556",18403,-1551,630000,0.05,63,963121
"1523",9988,183.5,1750000,0.65,175,963296
"3074",10798,-353,2190000,0.6,219,963515
"4231",17660,-805,640000,0.3,64,963579
"5531",248,-632,7e+05,0.3,70,963649
"6942",41583,-1758,4780000,0.05,478,964127
"4162",18366,-894,490000,0.3,49,964176
"866",22987,596,8e+05,0.775,80,964256
"1728",7880,250,720000,0.65,72,964328
"6275",8482,-1304,630000,0.1,63,964391
"3019",11099,-409,2160000,0.6,216,964607
"6248",8973,-1004,1120000,0.1,112,964719
"5518",496,-609,8e+05,0.3,80,964799
"5385",26778,-635,2240000,0.3,224,965023
"4886",10746,-733,1190000,0.3,119,965142
"3433",32229,-344,1.1e+07,0.6,1100,966242
"6616",17087,-1528,560000,0.05,56,966298
"2916",11867,-225,4530000,0.6,453,966751
"4175",37742,-899,1500000,0.3,150,966901
"2869",34261,-11,1820000,0.6,182,967083
"605",32306,800,2400000,0.775,240,967323
"1275",34810,195,3190000,0.65,319,967642
"1132",37119,76,7e+05,0.65,70,967712
"4547",35508,-953.5,4540000,0.3,454,968166
"5710",37032,-1429,1050000,0.1,105,968271
"5669",37243,-1060,560000,0.1,56,968327
"6171",10405,-1242,490000,0.1,49,968376
"4626",43540,-927,1400000,0.3,140,968516
"3861",27005,-304,3060000,0.6,306,968822
"2250",25240,190,560000,0.65,56,968878
"7008",23987,-1901,7e+05,0.05,70,968948
"2246",39904,49,4070000,0.65,407,969355
"4002",25532,-116,560000,0.6,56,969411
"4762",11656,-835,640000,0.3,64,969475
"5482",24734,-698,1500000,0.3,150,969625
"6752",35500,-1700,560000,0.05,56,969681
"4262",17207,-545,7e+05,0.3,70,969751
"1638",31710,228,490000,0.65,49,969800
"4450",14825,-517,560000,0.3,56,969856
"4347",16273,-985,490000,0.3,49,969905
"6844",10313,-1578,8e+05,0.05,80,969985
"3102",10618,-439,490000,0.6,49,970034
"5307",28045,-693,560000,0.3,56,970090
"4095",417,-398,1800000,0.6,180,970270
"5587",37915,-1157,7e+05,0.1,70,970340
"5903",14632,-1242,640000,0.1,64,970404
"7249",14228,-2412,8e+05,0.001,80,970484
"4960",10254,-687,640000,0.3,64,970548
"834",41096,786,8e+05,0.775,80,970628
"4721",11977,-931,1850000,0.3,185,970813
"5353",40932,-504,1e+06,0.3,100,970913
"2984",11301,-466.5,1680000,0.6,168,971081
"414",203,1017,560000,0.825,56,971137
"1452",10552,231,640000,0.65,64,971201
"3430",8759,-274,1560000,0.6,156,971357
"2647",14500,-206.666666666667,2290000,0.6,229,971586
"5902",36090,-1349,560000,0.1,56,971642
"2466",17402,-213,1190000,0.6,119,971761
"4831",11089,-620,1190000,0.3,119,971880
"1838",29628,109.5,5520000,0.65,552,972432
"6025",12865,-1376,7e+05,0.1,70,972502
"4862",43087,-507,1540000,0.3,154,972656
"4645",12962,-736,7e+05,0.3,70,972726
"6163",10521,-1247,630000,0.1,63,972789
"5377",20095,-1000,560000,0.3,56,972845
"3832",5079,-252,7e+05,0.6,70,972915
"4882",10701,-526.5,1400000,0.3,140,973055
"2189",2034,394,1360000,0.65,136,973191
"5480",25041,-908.5,1890000,0.3,189,973380
"3673",42201,-24,1190000,0.6,119,973499
"2846",43367,-149,1190000,0.6,119,973618
"4192",17954,-571,560000,0.3,56,973674
"6209",10182,-1031,490000,0.1,49,973723
"6761",13500,-1552,7e+05,0.05,70,973793
"6421",3168,-1203,640000,0.1,64,973857
"3661",6616,-75.5,3780000,0.6,378,974235
"3949",40399,-211,3690000,0.6,369,974604
"5622",18041,-1146,560000,0.1,56,974660
"5667",44010,-1133,1700000,0.1,170,974830
"4216",37475,-717,8e+05,0.3,80,974910
"1318",34151,230,2e+06,0.65,200,975110
"4320",16708,-758,2400000,0.3,240,975350
"6345",28376,-1300,8e+05,0.1,80,975430
"5463",39844,-576,8e+05,0.3,80,975510
"4522",14076,-946,2380000,0.3,238,975748
"6085",34206,-1372,640000,0.1,64,975812
"1836",29789,62,5980000,0.65,598,976410
"3879",26667,-254.333333333333,3460000,0.6,346,976756
"2939",11560,-86,8e+05,0.6,80,976836
"4515",14092,-807.5,1960000,0.3,196,977032
"6267",42442,-1413,1200000,0.1,120,977152
"4793",33854,-562,490000,0.3,49,977201
"4457",14682,-670.25,2630000,0.3,263,977464
"4297",36907,-668,1500000,0.3,150,977614
"4712",12107,-864,8e+05,0.3,80,977694
"4795",33911,-539.5,2310000,0.3,231,977925
"4324",36818,-998,1360000,0.3,136,978061
"5557",38383,-666,560000,0.3,56,978117
"6865",9277,-1993,1400000,0.05,140,978257
"4259",37197,-623,2520000,0.3,252,978509
"5326",27910,-835,560000,0.3,56,978565
"5287",28536,-849,1400000,0.3,140,978705
"4291",16817,-525.5,4400000,0.3,440,979145
"6129",11025,-1023,1360000,0.1,136,979281
"4488",14440,-926,1750000,0.3,175,979456
"4086",24106,-235.5,1340000,0.6,134,979590
"1522",10094,282,1490000,0.65,149,979739
"5747",16654,-1054,560000,0.1,56,979795
"6107",11211,-1489,560000,0.1,56,979851
"4808",11291,-530,1400000,0.3,140,979991
"4735",34238,-931,8e+05,0.3,80,980071
"4938",33121,-905,560000,0.3,56,980127
"1093",38635,654,1640000,0.775,164,980291
"5040",32422,-627,2160000,0.3,216,980507
"2849",12504,-236,1920000,0.6,192,980699
"6382",4746,-1409,1890000,0.1,189,980888
"6114",11178,-1489,490000,0.1,49,980937
"4201",37677,-504,4350000,0.3,435,981372
"2276",1456,456,7e+05,0.65,70,981442
"4854",10848,-725,560000,0.3,56,981498
"4656",12666,-562.5,2200000,0.3,220,981718
"5581",38059,-1224,2060000,0.1,206,981924
"5571",38172,-1391,560000,0.1,56,981980
"5866",14858,-1413,2750000,0.1,275,982255
"5178",31203,-904,13200000,0.3,1320,983575
"4634",43497,-951,1490000,0.3,149,983724
"6541",18604,-1967,1500000,0.05,150,983874
"1464",42915,329,810000,0.65,81,983955
"6296",7916,-1115,7e+05,0.1,70,984025
"6019",13066,-1424,1190000,0.1,119,984144
"6662",36555,-1605,2090000,0.05,209,984353
"3200",32911,-13.6666666666667,2120000,0.6,212,984565
"5145",31034,-897,9e+05,0.3,90,984655
"2600",14627,-52,2080000,0.6,208,984863
"3984",25921,-463.5,2190000,0.6,219,985082
"5908",36122,-1206,1050000,0.1,105,985187
"5769",16536,-1300,1190000,0.1,119,985306
"331",22809,1027,560000,0.825,56,985362
"5567",18958,-1196,490000,0.1,49,985411
"6916",6451,-1713,2160000,0.05,216,985627
"4328",36788,-967,2890000,0.3,289,985916
"4835",11041,-934,1190000,0.3,119,986035
"752",42032,548,8e+05,0.775,80,986115
"5755",16547,-1321,1e+06,0.1,100,986215
"5469",25251,-928,1530000,0.3,153,986368
"5245",29041,-834.666666666667,6920000,0.3,692,987060
"6002",13626,-1257,1e+06,0.1,100,987160
"5397",3211,-566,630000,0.3,63,987223
"2885",11862,-439,8e+05,0.6,80,987303
"680",7051,979,2800000,0.775,280,987583
"3491",8121,-47,1360000,0.6,136,987719
"2059",27006,392,8e+05,0.65,80,987799
"6377",27997,-1057,1500000,0.1,150,987949
"333",2828,1239,7e+05,0.825,70,988019
"4668",12492,-584,720000,0.3,72,988091
"5759",16283,-1220,1500000,0.1,150,988241
"1981",5451,67,1750000,0.65,175,988416
"6532",38255,-1501,7e+05,0.05,70,988486
"4935",33109,-546,640000,0.3,64,988550
"3394",42627,-209.666666666667,2260000,0.6,226,988776
"494",12047,756,490000,0.775,49,988825
"4473",36132,-655.333333333333,5260000,0.3,526,989351
"4278",37075,-997,7e+05,0.3,70,989421
"6342",28414,-1154,7e+05,0.1,70,989491
"4208",18044,-565,1440000,0.3,144,989635
"5215",6849,-642,3e+06,0.3,300,989935
"7095",17703,-2721,630000,0.001,63,989998
"1164",14944,417,8e+05,0.65,80,990078
"1766",29911,383,490000,0.65,49,990127
"5439",25892,-511,3450000,0.3,345,990472
"5280",28862,-506,560000,0.3,56,990528
"6127",11143,-1104,2550000,0.1,255,990783
"4956",10320,-668,640000,0.3,64,990847
"6364",28083,-1179,1360000,0.1,136,990983
"6271",8240,-1216,1830000,0.1,183,991166
"5698",37101,-1325,7e+05,0.1,70,991236
"5387",26724,-627,1360000,0.3,136,991372
"3997",25764,-311,8e+05,0.6,80,991452
"5937",14101,-1244.5,2360000,0.1,236,991688
"4154",18554,-697,640000,0.3,64,991752
"6572",17778,-1695.5,2520000,0.05,252,992004
"3199",10215,-71.5,1820000,0.6,182,992186
"3164",33081,-493.5,1270000,0.6,127,992313
"5412",26214,-915.333333333333,3100000,0.3,310,992623
"3055",33346,-269,7e+05,0.6,70,992693
"5525",38687,-756,7e+05,0.3,70,992763
"1882",29375,12,1e+06,0.65,100,992863
"6046",23753,-1060,1750000,0.1,175,993038
"3823",41186,-163,7e+05,0.6,70,993108
"4989",10190,-664,1700000,0.3,170,993278
"3511",30850,-408,4390000,0.6,439,993717
"4859",33508,-676,4330000,0.3,433,994150
"2953",33903,-180,490000,0.6,49,994199
"6567",17786,-1780,8e+05,0.05,80,994279
"6676",14987,-1527,8e+05,0.05,80,994359
"6428",26422,-1014,720000,0.1,72,994431
"5054",42749,-920,630000,0.3,63,994494
"910",22792,581,7e+05,0.775,70,994564
"5820",44393,-1379,9e+05,0.1,90,994654
"6430",2998,-1192,630000,0.1,63,994717
"5843",36310,-1155.5,980000,0.1,98,994815
"5172",8047,-1000,1820000,0.3,182,994997
"5007",10080,-633.666666666667,1990000,0.3,199,995196
"4249",37232,-538,2920000,0.3,292,995488
"6192",10499,-1204.5,1460000,0.1,146,995634
"5434",39959,-538,490000,0.3,49,995683
"4464",14478,-568.2,5070000,0.3,507,996190
"6418",26513,-1254,7e+05,0.1,70,996260
"2687",13844,-408,2360000,0.6,236,996496
"4242",17624,-636,1e+06,0.3,100,996596
"5944",14067,-1345,490000,0.1,49,996645
"5634",17837,-1046.25,2640000,0.1,264,996909
"4664",34687,-843,1.8e+07,0.3,1800,998709
"3634",29919,-260,4740000,0.6,474,999183
"5450",25516,-678,7e+05,0.3,70,999253
"5733",16801,-1402,7e+05,0.1,70,999323
"6599",17357,-1985,7e+05,0.05,70,999393
"4947",10511,-979,3400000,0.3,340,999733
"6270",31149,-1159,1050000,0.1,105,999838
"3158",33144,-170,2420000,0.6,242,1000080
"6024",12830,-1376,560000,0.1,56,1000136
"4140",38334,-835,1050000,0.3,105,1000241
"5185",21207,-938,490000,0.3,49,1000290
"3489",8192,-435,2330000,0.6,233,1000523
"6362",28864,-1432,17630000,0.1,1763,1002286
"3003",33772,-145,630000,0.6,63,1002349
"3024",43137,-477,1e+06,0.6,100,1002449
"6522",220,-1435,1560000,0.1,156,1002605
"1123",37817,142,5170000,0.65,517,1003122
"2377",23919,279,1700000,0.65,170,1003292
"6017",35262,-1012,7010000,0.1,701,1003993
"1521",32725,152,1850000,0.65,185,1004178
"6333",28819,-1154,7e+05,0.1,70,1004248
"5402",40617,-550,1700000,0.3,170,1004418
"5882",14918,-1467,8e+05,0.1,80,1004498
"6520",23947,-1190,7e+05,0.1,70,1004568
"5777",36777,-1099,1260000,0.1,126,1004694
"5596",18269,-1034,2160000,0.1,216,1004910
"2876",11925,-10,1290000,0.6,129,1005039
"5941",35904,-1413,4400000,0.1,440,1005479
"2154",2519,368,630000,0.65,63,1005542
"5489",24546,-505,560000,0.3,56,1005598
"5057",9411,-628,3150000,0.3,315,1005913
"3032",33566,-351,1260000,0.6,126,1006039
"3079",43019,-437,8e+05,0.6,80,1006119
"3270",10040,-5.33333333333333,2160000,0.6,216,1006335
"4159",37963,-839,560000,0.3,56,1006391
"5688",37095,-1215.5,1400000,0.1,140,1006531
"4250",37275,-525.333333333333,8990000,0.3,899,1007430
"5303",5391,-896,560000,0.3,56,1007486
"5345",4722,-792,490000,0.3,49,1007535
"4173",18259,-822.5,1500000,0.3,150,1007685
"6617",17033,-1523,7e+05,0.05,70,1007755
"2421",37800,-220,560000,0.6,56,1007811
"6128",43140,-1081,1360000,0.1,136,1007947
"6969",2911,-1519,1500000,0.05,150,1008097
"2652",35978,-363,3530000,0.6,353,1008450
"6909",7761,-1791,1e+06,0.05,100,1008550
"1348",21515,234,1e+06,0.65,100,1008650
"4805",11215,-854.666666666667,5050000,0.3,505,1009155
"659",8477,788,1500000,0.775,150,1009305
"3446",31573,-46,6630000,0.6,663,1009968
"7003",756,-1592,1350000,0.05,135,1010103
"5299",28178,-885,2260000,0.3,226,1010329
"2237",25631,151,630000,0.65,63,1010392
"6762",35491,-1582,4690000,0.05,469,1010861
"4584",35165,-532.5,2760000,0.3,276,1011137
"428",43936,818,8e+05,0.775,80,1011217
"5752",16567,-1121,1e+06,0.1,100,1011317
"5704",37012,-1298,8e+05,0.1,80,1011397
"5459",25562,-635,640000,0.3,64,1011461
"6308",7127,-1140,1e+06,0.1,100,1011561
"3454",8694,-223,2400000,0.6,240,1011801
"4300",36916,-525.5,3790000,0.3,379,1012180
"4024",39704,-232,1e+06,0.6,100,1012280
"1735",42386,177,3710000,0.65,371,1012651
"5297",5465,-896,1e+06,0.3,100,1012751
"6618",36977,-1523,560000,0.05,56,1012807
"5846",23843,-1245,1190000,0.1,119,1012926
"4871",10808,-671,3500000,0.3,350,1013276
"5968",14022,-1374,1700000,0.1,170,1013446
"5200",30540,-960,3550000,0.3,355,1013801
"5685",17319,-1179.5,1850000,0.1,185,1013986
"6888",8632,-1696,1850000,0.05,185,1014171
"1048",24306,850,5440000,0.775,544,1014715
"5898",14772,-1201,560000,0.1,56,1014771
"2148",2728,419,560000,0.65,56,1014827
"4174",37901,-741,4710000,0.3,471,1015298
"3403",31510,-381.5,1500000,0.6,150,1015448
"2957",33881,-495.333333333333,1890000,0.6,189,1015637
"6206",10356,-1044,2390000,0.1,239,1015876
"6914",42305,-1885,4200000,0.05,420,1016296
"4755",11746,-829,1700000,0.3,170,1016466
"3973",1924,-255,8e+05,0.6,80,1016546
"4593",35401,-600,1990000,0.3,199,1016745
"5363",27146,-878,1800000,0.3,180,1016925
"2447",17827,-500,2250000,0.6,225,1017150
"6121",11242,-1113,2750000,0.1,275,1017425
"6120",33766,-1327,1190000,0.1,119,1017544
"5599",37928,-1193.5,3550000,0.1,355,1017899
"6466",1547,-1139,1400000,0.1,140,1018039
"2683",35742,-270,8e+05,0.6,80,1018119
"4806",11174,-648,7e+05,0.3,70,1018189
"5692",17404,-1191.5,1490000,0.1,149,1018338
"6004",13757,-1339,5060000,0.1,506,1018844
"5792",15915,-1189,2160000,0.1,216,1019060
"4799",11392,-835,1990000,0.3,199,1019259
"6132",33532,-1426,3160000,0.1,316,1019575
"6194",10371,-1293,8e+05,0.1,80,1019655
"6512",507,-1192,9e+05,0.1,90,1019745
"3513",30996,-133,1910000,0.6,191,1019936
"6091",11878,-1394.75,3060000,0.1,306,1020242
"3679",6407,-11,560000,0.6,56,1020298
"5335",41056,-620,8e+05,0.3,80,1020378
"4255",37247,-693,560000,0.3,56,1020434
"1798",30261,12.5,10060000,0.65,1006,1021440
"2106",26544,189,8e+05,0.65,80,1021520
"4437",14974,-537.5,2260000,0.3,226,1021746
"2243",39840,384,640000,0.65,64,1021810
"2747",35252,-248,8e+05,0.6,80,1021890
"4513",43663,-634,7e+05,0.3,70,1021960
"4199",37754,-802,3200000,0.3,320,1022280
"2181",40281,119,560000,0.65,56,1022336
"3666",6836,-306,1e+06,0.6,100,1022436
"6380",20739,-1308,7e+05,0.1,70,1022506
"5619",37566,-1144,1e+06,0.1,100,1022606
"6268",8342,-1183,640000,0.1,64,1022670
"6317",29957,-1191,1e+06,0.1,100,1022770
"5290",41893,-506,3550000,0.3,355,1023125
"6861",9649,-1689,560000,0.05,56,1023181
"437",36195,629,490000,0.775,49,1023230
"5084",8695,-875,1e+06,0.3,100,1023330
"5894",14646,-1006.5,2260000,0.1,226,1023556
"5869",36261,-1365,7e+05,0.1,70,1023626
"4441",14976,-723,3060000,0.3,306,1023932
"2398",18608,-143,8e+05,0.6,80,1024012
"5639",37400,-1168,1990000,0.1,199,1024211
"6582",37317,-1789,8e+05,0.05,80,1024291
"1377",33885,127,7e+05,0.65,70,1024361
"4952",33285,-651,6300000,0.3,630,1024991
"5157",8048,-672,640000,0.3,64,1025055
"4691",12450,-564,1700000,0.3,170,1025225
"4336",36825,-766,7e+05,0.3,70,1025295
"3333",32148,-320,4880000,0.6,488,1025783
"6442",2414,-1098,640000,0.1,64,1025847
"5584",18516,-1477,490000,0.1,49,1025896
"5298",5308,-789,1500000,0.3,150,1026046
"7011",118,-1750,1190000,0.05,119,1026165
"3524",8090,-464,630000,0.6,63,1026228
"4692",34668,-923,2820000,0.3,282,1026510
"4758",34017,-946,630000,0.3,63,1026573
"4646",12998,-964,7e+05,0.3,70,1026643
"5465",1425,-660,8e+05,0.3,80,1026723
"5259",6240,-951,2990000,0.3,299,1027022
"5795",36763,-1248,3690000,0.1,369,1027391
"5300",41426,-780,8e+05,0.3,80,1027471
"6884",8771,-1909,1360000,0.05,136,1027607
"5703",17246,-1114,1e+06,0.1,100,1027707
"4613",13709,-535,1050000,0.3,105,1027812
"5911",43740,-1114,630000,0.1,63,1027875
"3165",10292,-396,1890000,0.6,189,1028064
"2436",37541,-376,7e+05,0.6,70,1028134
"6608",37103,-1511,560000,0.05,56,1028190
"6741",13954,-1578,490000,0.05,49,1028239
"3411",42646,-3,1500000,0.6,150,1028389
"4909",33228,-587,4620000,0.3,462,1028851
"1585",32060,174.5,1490000,0.65,149,1029000
"4786",11332,-874,7e+05,0.3,70,1029070
"5230",6383,-919,7e+05,0.3,70,1029140
"5580",38174,-1391,2500000,0.1,250,1029390
"4342",36710,-963,490000,0.3,49,1029439
"6281",8475,-1278,640000,0.1,64,1029503
"4447",36173,-600,1700000,0.3,170,1029673
"5871",36258,-1090,9e+05,0.1,90,1029763
"6919",29348,-1503,3850000,0.05,385,1030148
"5901",14594,-1059,560000,0.1,56,1030204
"4773",33999,-621,1960000,0.3,196,1030400
"4667",12625,-906,2890000,0.3,289,1030689
"6094",33958,-1217,8e+05,0.1,80,1030769
"5678",37177,-1059,2060000,0.1,206,1030975
"6246",9083,-1489.66666666667,2830000,0.1,283,1031258
"5289",29036,-710,8790000,0.3,879,1032137
"6639",16697,-1553,4250000,0.05,425,1032562
"4923",43000,-655,1e+06,0.3,100,1032662
"5936",35755,-1035,7e+05,0.1,70,1032732
"5219",29866,-852.5,2200000,0.3,220,1032952
"6052",12076,-1072.5,1260000,0.1,126,1033078
"3422",42534,-255,7e+05,0.6,70,1033148
"5138",8214,-758,1350000,0.3,135,1033283
"3833",41134,-53,1400000,0.6,140,1033423
"4914",33161,-788,560000,0.3,56,1033479
"6989",25888,-1924,7e+05,0.05,70,1033549
"6018",13539,-1424,560000,0.1,56,1033605
"2983",21490,-435,1e+06,0.6,100,1033705
"2767",13124,-292.666666666667,2200000,0.6,220,1033925
"1540",42850,358,8e+05,0.65,80,1034005
"6548",38090,-1809,2e+06,0.05,200,1034205
"3216",33015,-477,5120000,0.6,512,1034717
"5754",36828,-1321,7e+05,0.1,70,1034787
"5573",18704,-1227,3690000,0.1,369,1035156
"4608",13156,-865,8e+05,0.3,80,1035236
"6462",1666,-1453,490000,0.1,49,1035285
"4685",23748,-719,9e+05,0.3,90,1035375
"6086",21557,-1134.5,3250000,0.1,325,1035700
"4137",23910,-223,2360000,0.6,236,1035936
"5240",6661,-845,3570000,0.3,357,1036293
"1987",28203,190,560000,0.65,56,1036349
"6998",24796,-1814,1700000,0.05,170,1036519
"5355",27529,-878,1050000,0.3,105,1036624
"3671",42174,-225.5,1750000,0.6,175,1036799
"6136",11166,-1044,2500000,0.1,250,1037049
"5727",37073,-1058,5100000,0.1,510,1037559
"4888",10744,-525,7e+05,0.3,70,1037629
"858",40942,590,8e+05,0.775,80,1037709
"5735",36963,-1125,7e+05,0.1,70,1037779
"4932",10459,-550,1440000,0.3,144,1037923
"6715",35983,-1536,9e+05,0.05,90,1038013
"5288",5609,-739,8e+05,0.3,80,1038093
"5123",31256,-904,8e+05,0.3,80,1038173
"5117",8603,-874,1700000,0.3,170,1038343
"1399",33942,222,7980000,0.65,798,1039141
"5601",37791,-1099,7e+05,0.1,70,1039211
"4809",11246,-531,1e+06,0.3,100,1039311
"6518",24061,-1334,1800000,0.1,180,1039491
"6369",28042,-1063,630000,0.1,63,1039554
"4517",35679,-919,7e+05,0.3,70,1039624
"4448",14734,-872,560000,0.3,56,1039680
"6227",32668,-1336,560000,0.1,56,1039736
"5018",9954,-917.2,8600000,0.3,860,1040596
"4187",37687,-504,1700000,0.3,170,1040766
"6383",4705,-1308,8e+05,0.1,80,1040846
"5388",3299,-737,8e+05,0.3,80,1040926
"6245",9136,-1025,8e+05,0.1,80,1041006
"4557",35539,-575,1050000,0.3,105,1041111
"5037",9496,-890,7e+05,0.3,70,1041181
"5749",36917,-1238,8e+05,0.1,80,1041261
"5218",42221,-609,8e+05,0.3,80,1041341
"3918",26343,-338,490000,0.6,49,1041390
"5339",5130,-680,490000,0.3,49,1041439
"6038",43508,-1244,1440000,0.1,144,1041583
"2512",16783,-469,1190000,0.6,119,1041702
"6082",34079,-1251,1350000,0.1,135,1041837
"2905",21563,-20,1620000,0.6,162,1041999
"3338",42807,-173,2240000,0.6,224,1042223
"6217",10115,-1054,7e+05,0.1,70,1042293
"5503",813,-603,720000,0.3,72,1042365
"6279",8501,-1304,1360000,0.1,136,1042501
"6527",38577,-1460,720000,0.1,72,1042573
"2797",12728,-445,8e+05,0.6,80,1042653
"4591",13584,-573,8e+05,0.3,80,1042733
"6152",33304,-1091.66666666667,2050000,0.1,205,1042938
"6487",39703,-1388,8e+05,0.1,80,1043018
"1401",11116,184.5,1700000,0.65,170,1043188
"5784",43886,-1497,490000,0.1,49,1043237
"2230",39955,240,560000,0.65,56,1043293
"4354",36564,-931,8e+05,0.3,80,1043373
"5314",28157,-852,8e+05,0.3,80,1043453
"6409",4475,-1121,560000,0.1,56,1043509
"5738",36895,-1394.5,1490000,0.1,149,1043658
"5317",28205,-633.5,2400000,0.3,240,1043898
"1797",7036,324,490000,0.65,49,1043947
"4306",17013,-634,1990000,0.3,199,1044146
"4293",37029,-553,1440000,0.3,144,1044290
"4946",10412,-529.5,1920000,0.3,192,1044482
"6645",16596,-1551,1050000,0.05,105,1044587
"6196",33055,-1088,8e+05,0.1,80,1044667
"4884",10626,-850,8e+05,0.3,80,1044747
"4725",43346,-527,1190000,0.3,119,1044866
"6586",17479,-1891.5,1440000,0.05,144,1045010
"5672",17457,-1285,560000,0.1,56,1045066
"6980",1848,-1533,560000,0.05,56,1045122
"1629",31862,327,560000,0.65,56,1045178
"4180",37744,-571,9e+05,0.3,90,1045268
"6881",31854,-1813,1e+06,0.05,100,1045368
"5391",20005,-734,7e+05,0.3,70,1045438
"4852",43070,-623,640000,0.3,64,1045502
"4237",17599,-618,7e+05,0.3,70,1045572
"6977",26123,-1919,490000,0.05,49,1045621
"6640",16894,-1860,3060000,0.05,306,1045927
"4453",36114,-616,1260000,0.3,126,1046053
"6188",10541,-1307,1440000,0.1,144,1046197
"624",31701,596,560000,0.775,56,1046253
"5767",16174,-1206.33333333333,3750000,0.1,375,1046628
"4860",33448,-797,1500000,0.3,150,1046778
"4387",15598,-797,720000,0.3,72,1046850
"5613",37725,-1415,1e+06,0.1,100,1046950
"5508",24264,-908,490000,0.3,49,1046999
"5648",17676,-1364,640000,0.1,64,1047063
"5435",25885,-980,1700000,0.3,170,1047233
"5223",6655,-892,640000,0.3,64,1047297
"5987",35325,-1007,490000,0.1,49,1047346
"5086",31626,-553,630000,0.3,63,1047409
"613",42787,794,1260000,0.775,126,1047535
"3919",2793,-169,1700000,0.6,170,1047705
"6502",39222,-1359,720000,0.1,72,1047777
"6791",11781,-1602,720000,0.05,72,1047849
"3183",32977,-489,640000,0.6,64,1047913
"4918",43027,-964,2260000,0.3,226,1048139
"5862",14878,-1061.75,2540000,0.1,254,1048393
"2732",13589,-181,490000,0.6,49,1048442
"6883",8860,-1813,1190000,0.05,119,1048561
"6068",34262,-1065,8e+05,0.1,80,1048641
"6021",13260,-1113,1190000,0.1,119,1048760
"6388",27500,-1012,7e+05,0.1,70,1048830
"3785",28407,-251,8e+05,0.6,80,1048910
"6230",32667,-1206.33333333333,3700000,0.1,370,1049280
"5091",8811,-574,490000,0.3,49,1049329
"6376",4986,-1389,7e+05,0.1,70,1049399
"6961",40704,-1681,490000,0.05,49,1049448
"5593",18394,-1435,1360000,0.1,136,1049584
"6023",35031,-1486,1120000,0.1,112,1049696
"4757",11614,-654,2540000,0.3,254,1049950
"6334",41951,-1084,1500000,0.1,150,1050100
"2889",12044,-118.6,5380000,0.6,538,1050638
"6996",24869,-1771,560000,0.05,56,1050694
"5427",2077,-946,1050000,0.3,105,1050799
"5374",40759,-932,7e+05,0.3,70,1050869
"6063",34502,-1097,2260000,0.1,226,1051095
"4203",37621,-691,3690000,0.3,369,1051464
"4526",14081,-957,8e+05,0.3,80,1051544
"5806",36755,-1033,4250000,0.1,425,1051969
"5978",35495,-1064,8e+05,0.1,80,1052049
"4848",33539,-527.666666666667,4590000,0.3,459,1052508
"5478",24997,-538,1e+06,0.3,100,1052608
"5677",37158,-1337,560000,0.1,56,1052664
"6162",43004,-1242,560000,0.1,56,1052720
"5779",36849,-1479,1050000,0.1,105,1052825
"5375",3769,-1000,1190000,0.3,119,1052944
"6894",23700,-1540,560000,0.05,56,1053000
"4958",33096,-550,2550000,0.3,255,1053255
"4152",38055,-652,1e+06,0.3,100,1053355
"6851",32898,-1700,2560000,0.05,256,1053611
"5166",8092,-884,720000,0.3,72,1053683
"6057",11953,-1065,7e+05,0.1,70,1053753
"3900",26528,-146,2430000,0.6,243,1053996
"2790",43524,-196,9e+05,0.6,90,1054086
"4412",15307,-888,490000,0.3,49,1054135
"5800",15848,-1147,1440000,0.1,144,1054279
"4607",35529,-728,11670000,0.3,1167,1055446
"5111",31667,-574,6240000,0.3,624,1056070
"5980",35504,-1399,2630000,0.1,263,1056333
"2722",36002,-118,5550000,0.6,555,1056888
"5659",37212,-1136,1500000,0.1,150,1057038
"220",33597,1214,560000,0.825,56,1057094
"6373",27875,-1108,8e+05,0.1,80,1057174
"4630",13175,-550,1540000,0.3,154,1057328
"6787",34128,-1736,720000,0.05,72,1057400
"5158",30876,-528,1920000,0.3,192,1057592
"6053",34667,-1037,4600000,0.1,460,1058052
"2188",26111,438,7e+05,0.65,70,1058122
"2985",11210,-5,2300000,0.6,230,1058352
"3629",29697,-1,1050000,0.6,105,1058457
"4611",13644,-597,13850000,0.3,1385,1059842
"5603",37835,-1222,1050000,0.1,105,1059947
"6137",11136,-1468.5,2620000,0.1,262,1060209
"5998",35207,-1337,1700000,0.1,170,1060379
"4393",15743,-697,1530000,0.3,153,1060532
"5661",37253,-1222,1990000,0.1,199,1060731
"6072",34186,-1281,640000,0.1,64,1060795
"6335",5741,-1218.5,1120000,0.1,112,1060907
"6575",37449,-1603,720000,0.05,72,1060979
"5009",32779,-755,1990000,0.3,199,1061178
"5346",27603,-855,2060000,0.3,206,1061384
"5860",36251,-1201,490000,0.1,49,1061433
"5242",42148,-850,1120000,0.3,112,1061545
"6800",11431,-1519,7e+05,0.05,70,1061615
"5561",18966,-1084.5,1960000,0.1,196,1061811
"4621",13457,-625,560000,0.3,56,1061867
"6037",34857,-1226,1e+06,0.1,100,1061967
"4502",14323,-685,9e+05,0.3,90,1062057
"1693",31280,390,4320000,0.65,432,1062489
"1385",11343,193,2190000,0.65,219,1062708
"6200",33103,-1140,720000,0.1,72,1062780
"3275",10001,-346,560000,0.6,56,1062836
"5348",40989,-756,8e+05,0.3,80,1062916
"3015",43161,-180,490000,0.6,49,1062965
"2964",11312,-333,490000,0.6,49,1063014
"6034",12959,-1067,2960000,0.1,296,1063310
"5429",1716,-538,7e+05,0.3,70,1063380
"4399",36476,-577,1260000,0.3,126,1063506
"5615",18297,-1275,6260000,0.1,626,1064132
"6947",27568,-1613,7e+05,0.05,70,1064202
"6235",9509,-1057,1e+06,0.1,100,1064302
"4700",12305,-690,1200000,0.3,120,1064422
"6183",10472,-1023.5,1340000,0.1,134,1064556
"6689",36395,-1666,2260000,0.05,226,1064782
"5851",36344,-1203,1800000,0.1,180,1064962
"6337",28495,-1495,7e+05,0.1,70,1065032
"3190",42910,-207,640000,0.6,64,1065096
"6049",43359,-1282,560000,0.1,56,1065152
"3035",33477,-195,560000,0.6,56,1065208
"2238",25552,260,560000,0.65,56,1065264
"4361",21760,-907,7e+05,0.3,70,1065334
"3937",26264,-11,1990000,0.6,199,1065533
"6935",28333,-1905,490000,0.05,49,1065582
"5500",24392,-655,560000,0.3,56,1065638
"5823",36480,-1306,560000,0.1,56,1065694
"4561",13733,-522,1990000,0.3,199,1065893
"4311",36912,-967,1050000,0.3,105,1065998
"4583",35204,-731,560000,0.3,56,1066054
"6043",34499,-1214,1340000,0.1,134,1066188
"6626",16920,-1619,2600000,0.05,260,1066448
"5497",24378,-710,8e+05,0.3,80,1066528
"1306",34217,230,490000,0.65,49,1066577
"6355",5564,-1089.25,3240000,0.1,324,1066901
"6387",4737,-1193,1e+06,0.1,100,1067001
"6525",38605,-1460,640000,0.1,64,1067065
"6456",25868,-1036,1e+06,0.1,100,1067165
"5984",35333,-1261.5,1260000,0.1,126,1067291
"3393",8998,-405,7e+05,0.6,70,1067361
"5830",15324,-1385,640000,0.1,64,1067425
"6089",11562,-1065.33333333333,3170000,0.1,317,1067742
"5327",27862,-645,640000,0.3,64,1067806
"5802",15580,-1404,1760000,0.1,176,1067982
"5010",32820,-694,1700000,0.3,170,1068152
"6322",29239,-1049,7e+05,0.1,70,1068222
"4483",14300,-916.5,2630000,0.3,263,1068485
"4238",17491,-749,1e+06,0.3,100,1068585
"5618",37809,-1237,1890000,0.1,189,1068774
"5050",32655,-563,6440000,0.3,644,1069418
"4841",33551,-760,560000,0.3,56,1069474
"6444",26201,-1051,1190000,0.1,119,1069593
"6810",33488,-1567,1e+06,0.05,100,1069693
"1082",24029,674,7e+05,0.775,70,1069763
"6938",41581,-1758,1e+06,0.05,100,1069863
"5566",18851,-1368,560000,0.1,56,1069919
"4205",44091,-826,490000,0.3,49,1069968
"1867",29453,230,4140000,0.65,414,1070382
"4506",14152,-540,1e+06,0.3,100,1070482
"4302",36848,-626,7e+05,0.3,70,1070552
"6823",43145,-1731,2e+06,0.05,200,1070752
"4890",10678,-964,560000,0.3,56,1070808
"6457",1840,-1453,7e+05,0.1,70,1070878
"6219",10052,-1091,1400000,0.1,140,1071018
"4430",43786,-710,1290000,0.3,129,1071147
"5668",17449,-1065,560000,0.1,56,1071203
"4470",36058,-908,720000,0.3,72,1071275
"5058",32040,-878,630000,0.3,63,1071338
"5393",26521,-530.5,1540000,0.3,154,1071492
"4579",35450,-771,1530000,0.3,153,1071645
"4855",10885,-740,1260000,0.3,126,1071771
"5046",32412,-832,490000,0.3,49,1071820
"6314",6747,-1281,560000,0.1,56,1071876
"6765",13297,-1903,1050000,0.05,105,1071981
"6694",14809,-1514,1e+06,0.05,100,1072081
"5675",37149,-1018,490000,0.1,49,1072130
"6000",13422,-1064,1e+06,0.1,100,1072230
"5617",18019,-1146,1e+06,0.1,100,1072330
"6256",31614,-1145,2990000,0.1,299,1072629
"6724",14657,-1598,490000,0.05,49,1072678
"5602",37782,-1390,7e+05,0.1,70,1072748
"4232",17822,-805,640000,0.3,64,1072812
"6833",10520,-1851,7e+05,0.05,70,1072882
"6356",41691,-1026,2960000,0.1,296,1073178
"4997",32851,-818,1290000,0.3,129,1073307
"6473",1438,-1458,720000,0.1,72,1073379
"3479",8178,-446,630000,0.6,63,1073442
"6717",14390,-1809,1200000,0.05,120,1073562
"5999",35180,-1329,8e+05,0.1,80,1073642
"3142",42983,-205,1360000,0.6,136,1073778
"5295",5485,-851,1190000,0.3,119,1073897
"5652",17528,-1366,8e+05,0.1,80,1073977
"4211",37632,-970,8e+05,0.3,80,1074057
"6179",10637,-1244,1360000,0.1,136,1074193
"5809",15508,-1361,1760000,0.1,176,1074369
"5275",44250,-787,1800000,0.3,180,1074549
"4924",33173,-714,3250000,0.3,325,1074874
"5757",16439,-1062,1260000,0.1,126,1075000
"6627",36932,-1860,1e+06,0.05,100,1075100
"6169",33425,-1321,980000,0.1,98,1075198
"5165",8245,-830,3610000,0.3,361,1075559
"4451",14651,-883,1920000,0.3,192,1075751
"5506",668,-896,490000,0.3,49,1075800
"6783",11962,-1997,1050000,0.05,105,1075905
"6838",33158,-1609,490000,0.05,49,1075954
"6775",12706,-1782,7e+05,0.05,70,1076024
"5793",36684,-1189,1700000,0.1,170,1076194
"5912",14566,-1252.66666666667,2230000,0.1,223,1076417
"6620",16938,-1619,640000,0.05,64,1076481
"2468",43982,-219,560000,0.6,56,1076537
"5893",43751,-1243,5440000,0.1,544,1077081
"7013",38363,-1777,560000,0.05,56,1077137
"4562",13704,-852,5930000,0.3,593,1077730
"6975",2060,-1672,560000,0.05,56,1077786
"4359",44415,-876,1190000,0.3,119,1077905
"5635",37499,-1144,1500000,0.1,150,1078055
"4644",13396,-736,1360000,0.3,136,1078191
"4185",18075,-570,1e+06,0.3,100,1078291
"5976",13817,-1222,1440000,0.1,144,1078435
"4984",10106,-506,1500000,0.3,150,1078585
"6446",40226,-1148,490000,0.1,49,1078634
"4295",36935,-684.5,2360000,0.3,236,1078870
"6580",37255,-1520,560000,0.05,56,1078926
"5055",9377,-996,490000,0.3,49,1078975
"6208",42948,-1189,2400000,0.1,240,1079215
"4463",43725,-560,18350000,0.3,1835,1081050
"4215",37444,-717,560000,0.3,56,1081106
"5311",41493,-645,8e+05,0.3,80,1081186
"5897",14637,-1408,560000,0.1,56,1081242
"6276",8160,-1259,560000,0.1,56,1081298
"5815",15417,-1261,630000,0.1,63,1081361
"6416",26588,-1449,1e+06,0.1,100,1081461
"4937",33084,-843,560000,0.3,56,1081517
"4290",36934,-528,4530000,0.3,453,1081970
"5249",6423,-598,8e+05,0.3,80,1082050
"6799",11402,-1833,490000,0.05,49,1082099
"6994",24981,-1771,1e+06,0.05,100,1082199
"5753",16882,-1307,9e+05,0.1,90,1082289
"6471",25297,-1335,9e+05,0.1,90,1082379
"6934",28327,-1829,7e+05,0.05,70,1082449
"4386",15556,-576,2640000,0.3,264,1082713
"6186",33192,-1266,7e+05,0.1,70,1082783
"6933",28358,-1942,490000,0.05,49,1082832
"4969",10352,-941.5,1260000,0.3,126,1082958
"6739",35649,-1609,560000,0.05,56,1083014
"6736",13884,-1811,490000,0.05,49,1083063
"6979",26055,-1565,2600000,0.05,260,1083323
"5186",30387,-953,7e+05,0.3,70,1083393
"5313",5450,-645,640000,0.3,64,1083457
"4972",10279,-573,490000,0.3,49,1083506
"5973",35559,-1222,560000,0.1,56,1083562
"5765",16203,-1121,7e+05,0.1,70,1083632
"5110",8688,-874,7e+05,0.3,70,1083702
"4723",34462,-850,1360000,0.3,136,1083838
"2504",17138,-372,1200000,0.6,120,1083958
"5969",14086,-1131,5290000,0.1,529,1084487
"6347",5547,-1495,8e+05,0.1,80,1084567
"6174",10697,-1307,3940000,0.1,394,1084961
"6900",30923,-1565,1360000,0.05,136,1085097
"6231",9707,-1057,1050000,0.1,105,1085202
"6330",6011,-1432,8e+05,0.1,80,1085282
"6595",17468,-1565,560000,0.05,56,1085338
"5505",24275,-631,490000,0.3,49,1085387
"6709",14669,-1718,560000,0.05,56,1085443
"6558",37873,-1962,2890000,0.05,289,1085732
"5083",31679,-875,7e+05,0.3,70,1085802
"6588",17709,-1509,1440000,0.05,144,1085946
"6214",32955,-1433,1190000,0.1,119,1086065
"6470",1414,-1335,720000,0.1,72,1086137
"4538",13958,-592,1700000,0.3,170,1086307
"5121",42625,-515,3990000,0.3,399,1086706
"6178",10635,-1249,1340000,0.1,134,1086840
"4907",33263,-696,490000,0.3,49,1086889
"6229",9964,-1336,8e+05,0.1,80,1086969
"3387",8792,-115,1050000,0.6,105,1087074
"6257",42528,-1036,560000,0.1,56,1087130
"6148",10899,-1002,8e+05,0.1,80,1087210
"6547",37904,-1570,630000,0.05,63,1087273
"6852",32659,-1636,8e+05,0.05,80,1087353
"5192",30770,-564,3950000,0.3,395,1087748
"6454",40076,-1358,3690000,0.1,369,1088117
"6710",14589,-1718,8e+05,0.05,80,1088197
"5951",23802,-1240,560000,0.1,56,1088253
"6621",23335,-1893,1200000,0.05,120,1088373
"5740",16889,-1312,1700000,0.1,170,1088543
"2530",36661,-469,7e+05,0.6,70,1088613
"4004",39874,-53.5,1770000,0.6,177,1088790
"6869",9230,-1778,1260000,0.05,126,1088916
"6819",43092,-1662,640000,0.05,64,1088980
"4905",43035,-927,490000,0.3,49,1089029
"4321",16679,-737,3740000,0.3,374,1089403
"6666",15429,-1670,2150000,0.05,215,1089618
"5520",24109,-725,720000,0.3,72,1089690
"6860",32361,-1968,1e+06,0.05,100,1089790
"5625",37666,-1268,1190000,0.1,119,1089909
"4371",15647,-931,640000,0.3,64,1089973
"6701",14743,-1702,1260000,0.05,126,1090099
"4942",33030,-540,2260000,0.3,226,1090325
"6332",28520,-1154,7e+05,0.1,70,1090395
"6680",14929,-1790,7e+05,0.05,70,1090465
"5858",36328,-1189,1850000,0.1,185,1090650
"5805",15595,-1338,640000,0.1,64,1090714
"6863",9506,-1747,7e+05,0.05,70,1090784
"6771",35183,-1543.5,2540000,0.05,254,1091038
"6006",13632,-1012,1e+06,0.1,100,1091138
"5636",17734,-1034,560000,0.1,56,1091194
"6216",10152,-1351.5,1490000,0.1,149,1091343
"6460",40132,-1032,3040000,0.1,304,1091647
"4327",16190,-963,1190000,0.3,119,1091766
"4438",23816,-947,7e+05,0.3,70,1091836
"6829",10689,-1866,490000,0.05,49,1091885
"6509",39033,-1470,560000,0.1,56,1091941
"5883",36175,-1408,1260000,0.1,126,1092067
"6151",10766,-1075.5,2160000,0.1,216,1092283
"4200",37773,-802,2190000,0.3,219,1092502
"5301",5879,-642.857142857143,6540000,0.3,654,1093156
"4403",15944,-612,2500000,0.3,250,1093406
"4791",11326,-692,7e+05,0.3,70,1093476
"6221",33016,-1013,2860000,0.1,286,1093762
"6243",32061,-1060,2340000,0.1,234,1093996
"5379",40753,-619,1700000,0.3,170,1094166
"5718",36969,-1357,1360000,0.1,136,1094302
"5129",8494,-609,8e+05,0.3,80,1094382
"4206",17799,-971,560000,0.3,56,1094438
"6793",11584,-1619,640000,0.05,64,1094502
"5867",14803,-1058,1750000,0.1,175,1094677
"4264",17302,-626,5810000,0.3,581,1095258
"6405",27145,-1085,1800000,0.1,180,1095438
"5940",35771,-1269,1700000,0.1,170,1095608
"5852",15033,-1266,1260000,0.1,126,1095734
"4544",13768,-876,1130000,0.3,113,1095847
"6573",17745,-1690.66666666667,2320000,0.05,232,1096079
"6319",29693,-1176,3510000,0.1,351,1096430
"6743",13944,-1700,560000,0.05,56,1096486
"5577",38212,-1301,8e+05,0.1,80,1096566
"5390",3425,-899,1e+06,0.3,100,1096666
"6521",251,-1190,490000,0.1,49,1096715
"6873",31965,-1589.5,3110000,0.05,311,1097026
"6193",10642,-1140,640000,0.1,64,1097090
"6950",40867,-1519,7e+05,0.05,70,1097160
"6438",2350,-1351,810000,0.1,81,1097241
"5657",44040,-1065,8e+05,0.1,80,1097321
"5879",36216,-1039,1360000,0.1,136,1097457
"6751",13988,-1700,640000,0.05,64,1097521
"4541",13812,-665.5,3260000,0.3,326,1097847
"5939",14125,-1269,1190000,0.1,119,1097966
"6544",18574,-1809,8e+05,0.05,80,1098046
"5696",37064,-1019,8e+05,0.1,80,1098126
"4880",43018,-800,1e+06,0.3,100,1098226
"5958",35826,-1069,1890000,0.1,189,1098415
"4679",12570,-833,1360000,0.3,136,1098551
"6352",5428,-1278,1390000,0.1,139,1098690
"6386",27416,-1357,630000,0.1,63,1098753
"2272",22073,476,1e+06,0.65,100,1098853
"5702",17205,-1149,7e+05,0.1,70,1098923
"6891",31160,-1696,7e+05,0.05,70,1098993
"5818",15387,-1058,810000,0.1,81,1099074
"4331",16151,-832,490000,0.3,49,1099123
"5323",28037,-743,560000,0.3,56,1099179
"5699",17470,-1404,1e+06,0.1,100,1099279
"6540",38213,-1501,2550000,0.05,255,1099534
"4896",10606,-971,1680000,0.3,168,1099702
"5203",30438,-570,1610000,0.3,161,1099863
"6157",10728,-1270,2330000,0.1,233,1100096
"5087",31723,-882,1700000,0.3,170,1100266
"4518",35811,-552,560000,0.3,56,1100322
"6290",7891,-1395,1530000,0.1,153,1100475
"5933",14276,-1263,1990000,0.1,199,1100674
"4673",34697,-564,1430000,0.3,143,1100817
"6439",2694,-1189,640000,0.1,64,1100881
"6490",24916,-1481,1700000,0.1,170,1101051
"5803",15579,-1011.5,1270000,0.1,127,1101178
"4277",17262,-997,1190000,0.3,119,1101297
"6402",26999,-1151,720000,0.1,72,1101369
"4741",43318,-527,640000,0.3,64,1101433
"6001",13629,-1120,1e+06,0.1,100,1101533
"4253",17403,-819,1990000,0.3,199,1101732
"4845",33405,-797,560000,0.3,56,1101788
"6264",31064,-1102,630000,0.1,63,1101851
"6531",1,-1987.21428571429,10480000,0.05,1048,1102899
"6374",27866,-1108,560000,0.1,56,1102955
"6493",39681,-1388,560000,0.1,56,1103011
"4504",14071,-592,1e+06,0.3,100,1103111
"6649",36798,-1877,490000,0.05,49,1103160
"4684",12310,-719,720000,0.3,72,1103232
"6609",17445,-1908,1120000,0.05,112,1103344
"5887",14754,-1201,560000,0.1,56,1103400
"4392",15399,-689.5,1910000,0.3,191,1103591
"5376",3708,-1000,7e+05,0.3,70,1103661
"5095",42588,-600,490000,0.3,49,1103710
"5781",16127,-1151,3040000,0.1,304,1104014
"5664",17541,-1059,1e+06,0.1,100,1104114
"5641",17821,-1385,1530000,0.1,153,1104267
"6302",30386,-1337,2330000,0.1,233,1104500
"4885",43008,-850,1e+06,0.3,100,1104600
"6545",18352,-1962,1050000,0.05,105,1104705
"5417",26185,-810,3550000,0.3,355,1105060
"5892",14605,-1289,1340000,0.1,134,1105194
"6100",34036,-1475,1190000,0.1,119,1105313
"6908",30306,-1722,560000,0.05,56,1105369
"5967",13871,-1179,1260000,0.1,126,1105495
"6392",40940,-1307,1800000,0.1,180,1105675
"6929",6432,-1554,1700000,0.05,170,1105845
"6705",15295,-1779,8070000,0.05,807,1106652
"6672",36433,-1741,1050000,0.05,105,1106757
"6568",37586,-1512.5,2220000,0.05,222,1106979
"6119",11273,-1170,1700000,0.1,170,1107149
"4240",37224,-623,1e+06,0.3,100,1107249
"6226",32767,-1190,2400000,0.1,240,1107489
"6749",35604,-1811,560000,0.05,56,1107545
"6441",2299,-1252,560000,0.1,56,1107601
"4429",43788,-571,7e+05,0.3,70,1107671
"6806",21487,-1883,7e+05,0.05,70,1107741
"6427",3247,-1192,1440000,0.1,144,1107885
"7462",19760,-2067,560000,0.001,56,1107941
"6007",35420,-1119,1190000,0.1,119,1108060
"5988",13748,-1007,560000,0.1,56,1108116
"4730",34518,-646,2550000,0.3,255,1108371
"6526",186,-1006,630000,0.1,63,1108434
"5721",17016,-1017.5,1840000,0.1,184,1108618
"5620",44119,-1218,1360000,0.1,136,1108754
"6770",35130,-1903,7e+05,0.05,70,1108824
"5766",36760,-1337,560000,0.1,56,1108880
"6850",32740,-1636,1260000,0.05,126,1109006
"6105",33916,-1113,1750000,0.1,175,1109181
"6619",16900,-1740,560000,0.05,56,1109237
"6199",10357,-1140,630000,0.1,63,1109300
"6300",30340,-1115,1800000,0.1,180,1109480
"6488",1097,-1124,1e+06,0.1,100,1109580
"5608",18188,-1228,490000,0.1,49,1109629
"4728",34170,-829,1190000,0.3,119,1109748
"6062",12081,-1413,490000,0.1,49,1109797
"5631",18066,-1249,2950000,0.1,295,1110092
"6095",33922,-1394.5,1500000,0.1,150,1110242
"6412",26634,-1122,560000,0.1,56,1110298
"6054",34514,-1285,3690000,0.1,369,1110667
"5771",36774,-1019,7e+05,0.1,70,1110737
"7287",11764,-3184,9e+05,0.001,90,1110827
"5690",17330,-1415,7e+05,0.1,70,1110897
"4273",17213,-545,2360000,0.3,236,1111133
"6667",36448,-1819,560000,0.05,56,1111189
"6133",43115,-1412,1560000,0.1,156,1111345
"6584",37463,-1525,2260000,0.05,226,1111571
"6633",16723,-1666,1360000,0.05,136,1111707
"5291",28503,-683.5,3830000,0.3,383,1112090
"5650",37413,-1093,2730000,0.1,273,1112363
"6997",24805,-1618,8e+05,0.05,80,1112443
"6035",34896,-1268,8e+05,0.1,80,1112523
"6109",11514,-1087.66666666667,2450000,0.1,245,1112768
"6744",13869,-1700,1190000,0.05,119,1112887
"5915",14587,-1264,2160000,0.1,216,1113103
"5686",17305,-1041,560000,0.1,56,1113159
"5970",13982,-1130,1360000,0.1,136,1113295
"5814",36538,-1096,9e+05,0.1,90,1113385
"6432",26371,-1203,8e+05,0.1,80,1113465
"6122",11152,-1211,1400000,0.1,140,1113605
"7063",18445,-2134,7e+05,0.001,70,1113675
"5716",17110,-1020,560000,0.1,56,1113731
"4745",34074,-687.5,1360000,0.3,136,1113867
"4149",38144,-658,9e+05,0.3,90,1113957
"6177",33227,-1086,1e+06,0.1,100,1114057
"6033",13154,-1486,2500000,0.1,250,1114307
"5632",17881,-1415,8e+05,0.1,80,1114387
"6602",23404,-1908,1190000,0.05,119,1114506
"6483",1644,-1495,1750000,0.1,175,1114681
"4460",14666,-690,1050000,0.3,105,1114786
"5751",16534,-1352,1700000,0.1,170,1114956
"6876",8901,-1828,8e+05,0.05,80,1115036
"5671",17430,-1017,1540000,0.1,154,1115190
"6150",33321,-1235,1e+06,0.1,100,1115290
"5920",43734,-1239,1440000,0.1,144,1115434
"5148",8247,-629,1190000,0.3,119,1115553
"6684",15130,-1870,2550000,0.05,255,1115808
"6398",27123,-1076,490000,0.1,49,1115857
"6623",23275,-1574,560000,0.05,56,1115913
"6758",13749,-1676,1890000,0.05,189,1116102
"4851",11176,-972,3690000,0.3,369,1116471
"5960",13937,-1058.5,2420000,0.1,242,1116713
"6892",8473,-1688,490000,0.05,49,1116762
"6303",30174,-1345,490000,0.1,49,1116811
"6570",37459,-1679,630000,0.05,63,1116874
"5888",14855,-1059,490000,0.1,49,1116923
"6465",25834,-1036,1360000,0.1,136,1117059
"6272",8085,-1461,560000,0.1,56,1117115
"5627",17878,-1326,560000,0.1,56,1117171
"6912",7426,-1722,2330000,0.05,233,1117404
"6786",34216,-1736,630000,0.05,63,1117467
"6757",35439,-1849,2440000,0.05,244,1117711
"5614",18132,-1220,1190000,0.1,119,1117830
"6887",8514,-1696,490000,0.05,49,1117879
"6972",2384,-1598.5,1890000,0.05,189,1118068
"6185",10596,-1101,1700000,0.1,170,1118238
"6821",33444,-1806,2060000,0.05,206,1118444
"5881",14780,-1467,1e+06,0.1,100,1118544
"5027",32509,-686,2360000,0.3,236,1118780
"6134",10922,-1214.5,2340000,0.1,234,1119014
"5875",14840,-1203,1360000,0.1,136,1119150
"5357",40920,-728,560000,0.3,56,1119206
"6569",37617,-1667,8e+05,0.05,80,1119286
"5645",17772,-1326,2330000,0.1,233,1119519
"5919",14334,-1081,1120000,0.1,112,1119631
"5334",28015,-613,3110000,0.3,311,1119942
"6767",13169,-1900,630000,0.05,63,1120005
"6927",6439,-1946.5,1500000,0.05,150,1120155
"6498",39576,-1292,640000,0.1,64,1120219
"6211",10214,-1265,1400000,0.1,140,1120359
"7006",39189,-1545,1800000,0.05,180,1120539
"6365",28024,-1226,1440000,0.1,144,1120683
"5972",13771,-1399,560000,0.1,56,1120739
"6343",28639,-1154,7e+05,0.1,70,1120809
"6242",42771,-1223,630000,0.1,63,1120872
"6714",14485,-1709,9e+05,0.05,90,1120962
"6045",34467,-1006,8e+05,0.1,80,1121042
"5929",14618,-1374,5370000,0.1,537,1121579
"6514",38920,-1275,7e+05,0.1,70,1121649
"5971",13921,-1166.5,3400000,0.1,340,1121989
"6801",11410,-1519,560000,0.05,56,1122045
"6485",24975,-1018,7e+05,0.1,70,1122115
"6496",24446,-1486,7e+05,0.1,70,1122185
"5791",15910,-1352,7e+05,0.1,70,1122255
"6763",13104,-1854,1e+06,0.05,100,1122355
"6867",32201,-1747,2500000,0.05,250,1122605
"5756",36816,-1300,1e+06,0.1,100,1122705
"6566",17921,-1979.5,1430000,0.05,143,1122848
"5895",36105,-1408,8e+05,0.1,80,1122928
"6613",37044,-1523,8e+05,0.05,80,1123008
"6713",36004,-1709,630000,0.05,63,1123071
"6371",41241,-1158,1620000,0.1,162,1123233
"5914",14373,-1365,9e+05,0.1,90,1123323
"2764",13135,-242.5,2450000,0.6,245,1123568
"6123",11043,-1268.5,1430000,0.1,143,1123711
"6890",42453,-1696,8e+05,0.05,80,1123791
"5251",28916,-895,1e+06,0.3,100,1123891
"6695",14854,-1514,8e+05,0.05,80,1123971
"4975",10178,-620,1190000,0.3,119,1124090
"6413",26661,-1122,7e+05,0.1,70,1124160
"6991",25405,-1913,1440000,0.05,144,1124304
"5745",36938,-1224,2450000,0.1,245,1124549
"6141",10836,-1411,7e+05,0.1,70,1124619
"6011",35012,-1486,7e+05,0.1,70,1124689
"5216",6791,-978,1260000,0.3,126,1124815
"6160",10677,-1013,3690000,0.1,369,1125184
"5282",28680,-673.5,1990000,0.3,199,1125383
"5630",17814,-1273.5,1270000,0.1,127,1125510
"5638",37472,-1124,1700000,0.1,170,1125680
"6647",15999,-1790,630000,0.05,63,1125743
"5687",17325,-1018,1050000,0.1,105,1125848
"6358",5566,-1256.5,3450000,0.1,345,1126193
"6644",36802,-1742,560000,0.05,56,1126249
"6468",25612,-1266,490000,0.1,49,1126298
"6158",10758,-1235,1750000,0.1,175,1126473
"5453",1474,-997,560000,0.3,56,1126529
"5662",37190,-1018,7e+05,0.1,70,1126599
"6782",34283,-1682,1050000,0.05,105,1126704
"6553",18100,-1753,1e+06,0.05,100,1126804
"5693",17434,-1265,7e+05,0.1,70,1126874
"4694",34520,-723.5,1490000,0.3,149,1127023
"6138",43102,-1066,1200000,0.1,120,1127143
"6671",36427,-1744,1050000,0.05,105,1127248
"6896",23686,-1540,2090000,0.05,209,1127457
"6459",25976,-1190,1700000,0.1,170,1127627
"5884",36170,-1408,490000,0.1,49,1127676
"6101",33898,-1334,1260000,0.1,126,1127802
"6097",43192,-1366,2260000,0.1,226,1128028
"5928",35985,-1214,2630000,0.1,263,1128291
"6606",17320,-1507,1050000,0.05,105,1128396
"6936",5360,-1880,7e+05,0.05,70,1128466
"6949",4238,-1895,8e+05,0.05,80,1128546
"6191",33146,-1269,8e+05,0.1,80,1128626
"5982",13575,-1369,490000,0.1,49,1128675
"6760",13730,-1588.5,4350000,0.05,435,1129110
"6433",26379,-1331,7e+05,0.1,70,1129180
"6962",40707,-1615,1120000,0.05,112,1129292
"4601",13241,-585,7e+05,0.3,70,1129362
"6669",15981,-1561,6500000,0.05,650,1130012
"7327",32512,-2982,560000,0.001,56,1130068
"6537",18702,-1501,1050000,0.05,105,1130173
"6346",28387,-1300,7e+05,0.1,70,1130243
"6773",12754,-1859,7e+05,0.05,70,1130313
"6878",31829,-1626,1200000,0.05,120,1130433
"4252",17486,-545.5,2060000,0.3,206,1130639
"6517",24069,-1079,3550000,0.1,355,1130994
"5739",36847,-1206,7e+05,0.1,70,1131064
"6176",10702,-1074,4690000,0.1,469,1131533
"6723",36020,-1635,8e+05,0.05,80,1131613
"6612",17162,-1528,8e+05,0.05,80,1131693
"5437",25785,-985,1800000,0.3,180,1131873
"6830",10725,-1777,7e+05,0.05,70,1131943
"5705",37136,-1019,7e+05,0.1,70,1132013
"4281",36972,-993.75,2640000,0.3,264,1132277
"5873",15040,-1201,3750000,0.1,375,1132652
"6981",40006,-1533,490000,0.05,49,1132701
"6963",3574,-1549,630000,0.05,63,1132764
"5938",14095,-1131,8e+05,0.1,80,1132844
"6943",41311,-1545,2340000,0.05,234,1133078
"5886",36172,-1201,490000,0.1,49,1133127
"6255",8760,-1391,490000,0.1,49,1133176
"6020",23083,-1209,560000,0.1,56,1133232
"6796",33973,-1619,1800000,0.05,180,1133412
"6875",31830,-1827.5,1260000,0.05,126,1133538
"5839",15301,-1306,1050000,0.1,105,1133643
"6789",34141,-1743,630000,0.05,63,1133706
"5905",36230,-1395,5130000,0.1,513,1134219
"6474",25308,-1160,720000,0.1,72,1134291
"6820",33434,-1806,490000,0.05,49,1134340
"5855",15159,-1058,2500000,0.1,250,1134590
"6318",29431,-1280,7e+05,0.1,70,1134660
"4982",10104,-764,8e+05,0.3,80,1134740
"6381",4858,-1308,560000,0.1,56,1134796
"6759",35347,-1975,7e+05,0.05,70,1134866
"5790",15868,-1201,1600000,0.1,160,1135026
"6636",16467,-1503.5,3150000,0.05,315,1135341
"6168",10806,-1305,3240000,0.1,324,1135665
"6284",42373,-1395,560000,0.1,56,1135721
"6841",10417,-1733,8e+05,0.05,80,1135801
"6722",14349,-1635,560000,0.05,56,1135857
"6587",37267,-1906,560000,0.05,56,1135913
"6703",36106,-1527,7e+05,0.05,70,1135983
"6686",36260,-1515.5,1260000,0.05,126,1136109
"6577",37303,-1621,9e+05,0.05,90,1136199
"5568",18648,-1227,560000,0.1,56,1136255
"4556",35481,-607,8e+05,0.3,80,1136335
"6241",9306,-1364,1190000,0.1,119,1136454
"4521",14099,-888,2940000,0.3,294,1136748
"6530",16,-1426,1260000,0.1,126,1136874
"6501",39167,-1364,640000,0.1,64,1136938
"6239",32161,-1046,7e+05,0.1,70,1137008
"6508",39035,-1470,490000,0.1,49,1137057
"6422",26466,-1254,640000,0.1,64,1137121
"6971",26232,-1598.5,3690000,0.05,369,1137490
"6856",32529,-1968,640000,0.05,64,1137554
"6596",37163,-1757,490000,0.05,49,1137603
"6988",1628,-1787,7e+05,0.05,70,1137673
"5877",36206,-1408,1e+06,0.1,100,1137773
"5707",37074,-1247,1190000,0.1,119,1137892
"6436",2679,-1004.5,1460000,0.1,146,1138038
"6431",26402,-1105,1700000,0.1,170,1138208
"6397",27115,-1076,560000,0.1,56,1138264
"6077",34161,-1315,720000,0.1,72,1138336
"6650",36745,-1636,2460000,0.05,246,1138582
"6730",35752,-1570,8e+05,0.05,80,1138662
"5993",35245,-1152,1500000,0.1,150,1138812
"5789",16343,-1238,1920000,0.1,192,1139004
"6201",33043,-1158,720000,0.1,72,1139076
"6390",40903,-1076,1700000,0.1,170,1139246
"6658",36647,-1730,3720000,0.05,372,1139618
"6144",10896,-1040,560000,0.1,56,1139674
"6893",31372,-1688,560000,0.05,56,1139730
"5629",17895,-1423,560000,0.1,56,1139786
"6924",42109,-1559,490000,0.05,49,1139835
"6026",35055,-1051,1820000,0.1,182,1140017
"6407",3854,-1257,1500000,0.1,150,1140167
"6915",30042,-1535,560000,0.05,56,1140223
"6657",15493,-1640,7e+05,0.05,70,1140293
"5854",43778,-1326,1e+06,0.1,100,1140393
"5954",14042,-1301,8e+05,0.1,80,1140473
"4763",34236,-915,2330000,0.3,233,1140706
"5834",43819,-1471.5,1800000,0.1,180,1140886
"5922",14338,-1045.5,2060000,0.1,206,1141092
"5853",43784,-1326,7e+05,0.1,70,1141162
"7073",18396,-2614,1610000,0.001,161,1141323
"6237",32129,-1111,2360000,0.1,236,1141559
"6708",36156,-1702,8e+05,0.05,80,1141639
"6811",11069,-1567,7e+05,0.05,70,1141709
"5997",13529,-1064,2400000,0.1,240,1141949
"5896",36115,-1408,640000,0.1,64,1142013
"5819",36514,-1309,2070000,0.1,207,1142220
"6403",26952,-1131,1360000,0.1,136,1142356
"6478",23538,-1112,8e+05,0.1,80,1142436
"5078",9212,-585,1e+06,0.3,100,1142536
"5679",37117,-1363,7e+05,0.1,70,1142606
"5825",15803,-1064,2890000,0.1,289,1142895
"7296",11303,-3252,560000,0.001,56,1142951
"6792",11729,-1526,1360000,0.05,136,1143087
"4726",11972,-727,1280000,0.3,128,1143215
"4772",34047,-591,1e+06,0.3,100,1143315
"6560",37816,-1932,1e+06,0.05,100,1143415
"6250",9021,-1175,560000,0.1,56,1143471
"6198",10393,-1363,720000,0.1,72,1143543
"5562",38337,-1133.66666666667,4500000,0.1,450,1143993
"6635",16731,-1998,7e+05,0.05,70,1144063
"6960",26809,-1662,2260000,0.05,226,1144289
"6687",14856,-1526,1050000,0.05,105,1144394
"5742",16930,-1192,1190000,0.1,119,1144513
"6655",16084,-1735,1800000,0.05,180,1144693
"5612",44105,-1218,7e+05,0.1,70,1144763
"6605",17462,-1757,1890000,0.05,189,1144952
"6885",31651,-1564,2190000,0.05,219,1145171
"5829",15394,-1096,2340000,0.1,234,1145405
"6393",4711,-1193,490000,0.1,49,1145454
"6031",12884,-1432,9e+05,0.1,90,1145544
"6238",9732,-1342.5,3100000,0.1,310,1145854
"6396",27110,-1280,560000,0.1,56,1145910
"6504",39169,-1364,7e+05,0.1,70,1145980
"5658",17628,-1236,3140000,0.1,314,1146294
"6539",18863,-1781,560000,0.05,56,1146350
"6691",36303,-1595,1700000,0.05,170,1146520
"5913",14817,-1090,4540000,0.1,454,1146974
"5563",18954,-1282,1290000,0.1,129,1147103
"5598",37997,-1264.5,4740000,0.1,474,1147577
"6704",14940,-1702,2500000,0.05,250,1147827
"5831",36423,-1385,560000,0.1,56,1147883
"5798",16293,-1241,6700000,0.1,670,1148553
"6546",37960,-1962,7e+05,0.05,70,1148623
"5899",14748,-1201,1360000,0.1,136,1148759
"6788",34108,-1526,630000,0.05,63,1148822
"5975",35533,-1265,8e+05,0.1,80,1148902
"6583",17621,-1789,1200000,0.05,120,1149022
"5082",31531,-871.666666666667,2690000,0.3,269,1149291
"6923",6365,-1554,560000,0.05,56,1149347
"6552",18278,-1732.66666666667,2010000,0.05,201,1149548
"5849",15134,-1201,1500000,0.1,150,1149698
"6679",36373,-1595,1500000,0.05,150,1149848
"5842",15180,-1155,2310000,0.1,231,1150079
"6818",10840,-1662,8e+05,0.05,80,1150159
"5583",37946,-1347,560000,0.1,56,1150215
"6435",26249,-1102,560000,0.1,56,1150271
"6607",17372,-1523,1120000,0.05,112,1150383
"6648",36771,-1542.5,1260000,0.05,126,1150509
"6795",11465,-1804,640000,0.05,64,1150573
"5576",38054,-1347,7e+05,0.1,70,1150643
"6538",18640,-1785,1050000,0.05,105,1150748
"4558",13850,-928,4890000,0.3,489,1151237
"5616",18179,-1097,2890000,0.1,289,1151526
"6784",11979,-1682,1200000,0.05,120,1151646
"6088",11665,-1216,8e+05,0.1,80,1151726
"6225",32647,-1369,560000,0.1,56,1151782
"6728",14206,-1951,2700000,0.05,270,1152052
"7012",38478,-1656,7e+05,0.05,70,1152122
"6592",37330,-1665,1440000,0.05,144,1152266
"6550",18261,-1962,8e+05,0.05,80,1152346
"6732",35787,-1523.33333333333,3990000,0.05,399,1152745
"6797",11484,-1519,1260000,0.05,126,1152871
"6103",33827,-1327,490000,0.1,49,1152920
"6965",26658,-1887,1260000,0.05,126,1153046
"5981",13762,-1198,490000,0.1,49,1153095
"5697",17168,-1428,8e+05,0.1,80,1153175
"5586",18312,-1157,560000,0.1,56,1153231
"6503",740,-1292,8e+05,0.1,80,1153311
"6781",34692,-1719,2170000,0.05,217,1153528
"6099",11677,-1389.5,5420000,0.1,542,1154070
"6014",13285,-1166,490000,0.1,49,1154119
"6130",33577,-1094,2920000,0.1,292,1154411
"6184",10485,-1101,8e+05,0.1,80,1154491
"5564",38330,-1196,1700000,0.1,170,1154661
"5874",15013,-1374,2260000,0.1,226,1154887
"6145",43147,-1365,3110000,0.1,311,1155198
"5775",36781,-1457,1190000,0.1,119,1155317
"6678",15006,-1657,8e+05,0.05,80,1155397
"5983",13820,-1158,630000,0.1,63,1155460
"4481",14382,-854.5,2450000,0.3,245,1155705
"6835",33231,-1866,490000,0.05,49,1155754
"6113",11184,-1164,7e+05,0.1,70,1155824
"6866",32047,-1931,560000,0.05,56,1155880
"6389",27384,-1280,7e+05,0.1,70,1155950
"6395",27142,-1280,490000,0.1,49,1155999
"6557",37698,-1551,560000,0.05,56,1156055
"5719",16987,-1394,640000,0.1,64,1156119
"6510",599,-1470,1050000,0.1,105,1156224
"6641",16289,-1872,7e+05,0.05,70,1156294
"5783",16204,-1397,2450000,0.1,245,1156539
"6075",11662,-1176,1520000,0.1,152,1156691
"6954",27048,-1818,1e+06,0.05,100,1156791
"7366",30809,-2726,560000,0.001,56,1156847
"4927",33229,-625,2100000,0.3,210,1157057
"6802",33863,-1519,490000,0.05,49,1157106
"5712",37048,-1295,630000,0.1,63,1157169
"5782",16533,-1397,1120000,0.1,112,1157281
"5723",16918,-1259.66666666667,4e+06,0.1,400,1157681
"6959",40737,-1681,2500000,0.05,250,1157931
"6499",39337,-1155,9e+05,0.1,90,1158021
"5591",18565,-1351,490000,0.1,49,1158070
"6776",12837,-1782,8e+05,0.05,80,1158150
"6251",31802,-1473,1130000,0.1,113,1158263
"6581",37481,-1685,3610000,0.05,361,1158624
"6804",33828,-1810,7e+05,0.05,70,1158694
"5713",17026,-1149,490000,0.1,49,1158743
"5720",36949,-1394,8e+05,0.1,80,1158823
"6871",32019,-1979,7e+05,0.05,70,1158893
"5817",15725,-1068,5220000,0.1,522,1159415
"6622",23253,-1858,640000,0.05,64,1159479
"6756",13631,-1975,1e+06,0.05,100,1159579
"5840",15369,-1235,2200000,0.1,220,1159799
"6803",11349,-1810,5740000,0.05,574,1160373
"6735",35733,-1570,2990000,0.05,299,1160672
"6469",1515,-1266,560000,0.1,56,1160728
"5966",35675,-1399,1190000,0.1,119,1160847
"5748",16771,-1311,560000,0.1,56,1160903
"6549",44128,-1753,560000,0.05,56,1160959
"6944",28017,-1838,2340000,0.05,234,1161193
"5680",23400,-1064,630000,0.1,63,1161256
"6660",15451,-1602,1620000,0.05,162,1161418
"6106",11381,-1489,490000,0.1,49,1161467
"6366",5087,-1094,1280000,0.1,128,1161595
"6484",1206,-1495,560000,0.1,56,1161651
"6328",6090,-1403.5,1990000,0.1,199,1161850
"5623",17997,-1406.5,1340000,0.1,134,1161984
"6700",36150,-1702,1050000,0.05,105,1162089
"6824",43048,-1662,1750000,0.05,175,1162264
"6834",10700,-1866,1120000,0.05,112,1162376
"6995",1211,-1629,2160000,0.05,216,1162592
"6574",37571,-1858,9e+05,0.05,90,1162682
"6711",14581,-1527,8e+05,0.05,80,1162762
"6985",1703,-1617,7e+05,0.05,70,1162832
"6964",3468,-1887,1190000,0.05,119,1162951
"7107",17366,-3172,1e+06,0.001,100,1163051
"7454",26839,-2866,560000,0.001,56,1163107
"5647",17753,-1345,2260000,0.1,226,1163333
"5592",18358,-1237,490000,0.1,49,1163382
"6424",26447,-1319,560000,0.1,56,1163438
"6727",35798,-1533,1260000,0.05,126,1163564
"6978",1965,-1809,7e+05,0.05,70,1163634
"5813",15565,-1218,1520000,0.1,152,1163786
"6305",30233,-1061,1990000,0.1,199,1163985
"6827",43013,-1574,7e+05,0.05,70,1164055
"6426",19810,-1439,560000,0.1,56,1164111
"6826",43039,-1670,1460000,0.05,146,1164257
"5758",37364,-1005.33333333333,13550000,0.1,1355,1165612
"6809",11195,-1883,1e+06,0.05,100,1165712
"7471",25759,-2447,7e+05,0.001,70,1165782
"6750",13934,-1692,8e+05,0.05,80,1165862
"6013",43525,-1166,7e+05,0.1,70,1165932
"6719",14455,-1727,1120000,0.05,112,1166044
"6232",32241,-1364,560000,0.1,56,1166100
"5946",14090,-1214,1700000,0.1,170,1166270
"6983",1725,-1787,7e+05,0.05,70,1166340
"6690",14894,-1630.5,1490000,0.05,149,1166489
"5828",15400,-1276,1360000,0.1,136,1166625
"6479",1259,-1495,8e+05,0.1,80,1166705
"6697",14753,-1666,7e+05,0.05,70,1166775
"5768",36768,-1321,7e+05,0.1,70,1166845
"6578",37392,-1992,560000,0.05,56,1166901
"6289",30874,-1468,9e+05,0.1,90,1166991
"6905",7666,-1861,490000,0.05,49,1167040
"6780",12592,-1719,560000,0.05,56,1167096
"6738",13974,-1609,1130000,0.05,113,1167209
"5872",36227,-1090,7e+05,0.1,70,1167279
"5724",37068,-1114,4550000,0.1,455,1167734
"6104",11320,-1113,560000,0.1,56,1167790
"7379",7512,-2744,1e+06,0.001,100,1167890
"5708",37010,-1325,490000,0.1,49,1167939
"6600",17524,-1896,1990000,0.05,199,1168138
"6848",10171,-1702,8e+05,0.05,80,1168218
"6917",29276,-1528,560000,0.05,56,1168274
"6880",31866,-1813,8e+05,0.05,80,1168354
"7126",21934,-3160,7e+05,0.001,70,1168424
"5917",36065,-1329,1350000,0.1,135,1168559
"5743",16912,-1062,7e+05,0.1,70,1168629
"6338",28485,-1495,560000,0.1,56,1168685
"6937",5352,-1788.5,1490000,0.05,149,1168834
"6854",32624,-1820,560000,0.05,56,1168890
"5950",13987,-1015,3910000,0.1,391,1169281
"6903",7895,-1885,7e+05,0.05,70,1169351
"7024",18887,-2928,7e+05,0.001,70,1169421
"6651",16572,-1649,2900000,0.05,290,1169711
"6982",25845,-1592,1800000,0.05,180,1169891
"5582",37938,-1224,640000,0.1,64,1169955
"6090",11539,-1296.5,1360000,0.1,136,1170091
"6297",30309,-1061,560000,0.1,56,1170147
"5826",15560,-1103,2800000,0.1,280,1170427
"5610",18383,-1121.5,1290000,0.1,129,1170556
"6726",35886,-1635,490000,0.05,49,1170605
"7135",16929,-2632,8e+05,0.001,80,1170685
"6220",32764,-1054,7e+05,0.1,70,1170755
"6629",16730,-1836,560000,0.05,56,1170811
"6634",16828,-1666,3190000,0.05,319,1171130
"5605",18220,-1085,1190000,0.1,119,1171249
"5891",36152,-1248,7e+05,0.1,70,1171319
"6855",9856,-1820,7e+05,0.05,70,1171389
"6902",8006,-1791,560000,0.05,56,1171445
"6463",1668,-1453,7e+05,0.1,70,1171515
"5992",13355,-1129,490000,0.1,49,1171564
"6143",10950,-1004,8410000,0.1,841,1172405
"6682",36306,-1708.33333333333,1900000,0.05,190,1172595
"6625",36960,-1637,1440000,0.05,144,1172739
"6778",12611,-1869,1e+06,0.05,100,1172839
"6443",19363,-1348.5,2050000,0.1,205,1173044
"6628",16651,-1800.5,1560000,0.05,156,1173200
"7007",39221,-1545,1990000,0.05,199,1173399
"7002",39531,-1547,8e+05,0.05,80,1173479
"6543",18378,-1920,1120000,0.05,112,1173591
"6593",17413,-1782,8e+05,0.05,80,1173671
"6156",42997,-1123,7e+05,0.1,70,1173741
"7452",26814,-2193,7e+05,0.001,70,1173811
"5701",17185,-1295,9e+05,0.1,90,1173901
"6266",23695,-1304,640000,0.1,64,1173965
"6450",26140,-1316,5690000,0.1,569,1174534
"6664",36413,-1779,8e+05,0.05,80,1174614
"6339",28447,-1026,7e+05,0.1,70,1174684
"5579",38037,-1232,640000,0.1,64,1174748
"6794",43222,-1804,560000,0.05,56,1174804
"6056",12084,-1006,1750000,0.1,175,1174979
"5945",14365,-1231,4580000,0.1,458,1175437
"6249",31759,-1175,8e+05,0.1,80,1175517
"6125",11013,-1023,7e+05,0.1,70,1175587
"6420",3187,-1319,1e+06,0.1,100,1175687
"6808",11096,-1925,490000,0.05,49,1175736
"6970",26210,-1640,1260000,0.05,126,1175862
"6576",37365,-1670,720000,0.05,72,1175934
"7166",43923,-3189,7e+05,0.001,70,1176004
"5569",38276,-1243,3950000,0.1,395,1176399
"5953",14103,-1481,1500000,0.1,150,1176549
"5695",17358,-1019,1e+06,0.1,100,1176649
"6677",36353,-1684,1700000,0.05,170,1176819
"6907",30241,-1722,490000,0.05,49,1176868
"6968",26813,-1662,1680000,0.05,168,1177036
"6879",8932,-1579,560000,0.05,56,1177092
"5626",17834,-1144,560000,0.1,56,1177148
"6698",14943,-1790,4060000,0.05,406,1177554
"5801",23859,-1290,1500000,0.1,150,1177704
"6815",33618,-1637,640000,0.05,64,1177768
"6837",33376,-1777,560000,0.05,56,1177824
"6967",3409,-1975,7e+05,0.05,70,1177894
"5628",37577,-1326,8e+05,0.1,80,1177974
"5572",38153,-1057,1500000,0.1,150,1178124
"6737",13932,-1811,560000,0.05,56,1178180
"6877",8898,-1677,560000,0.05,56,1178236
"6910",30546,-1791,8e+05,0.05,80,1178316
"6590",17580,-1757,1500000,0.05,150,1178466
"7401",6000,-3242,560000,0.001,56,1178522
"5653",17762,-1367,1360000,0.1,136,1178658
"6673",36390,-1875,1260000,0.05,126,1178784
"6986",25828,-1592,7e+05,0.05,70,1178854
"6351",28284,-1122,560000,0.1,56,1178910
"6945",5134,-1803,640000,0.05,64,1178974
"7054",18653,-2282,490000,0.001,49,1179023
"6445",26191,-1271,560000,0.1,56,1179079
"6926",29077,-1996,7e+05,0.05,70,1179149
"6889",8449,-1696,9e+05,0.05,90,1179239
"6925",6180,-1996,1e+06,0.05,100,1179339
"6946",27650,-1613,560000,0.05,56,1179395
"6282",8212,-1258.5,4880000,0.1,488,1179883
"6904",7643,-1885,560000,0.05,56,1179939
"6467",39996,-1051,2190000,0.1,219,1180158
"7398",6162,-2604,1700000,0.001,170,1180328
"6747",35630,-1558,1190000,0.05,119,1180447
"6846",10185,-1700,8e+05,0.05,80,1180527
"6253",31671,-1261,4360000,0.1,436,1180963
"6098",11483,-1034,7e+05,0.1,70,1181033
"5737",16924,-1224,1e+06,0.1,100,1181133
"6931",28464,-1856,7e+05,0.05,70,1181203
"6159",10682,-1013,490000,0.1,49,1181252
"6653",15651,-1980,7e+05,0.05,70,1181322
"6898",30881,-1517,1360000,0.05,136,1181458
"6816",33673,-1531,8e+05,0.05,80,1181538
"6974",2417,-1864,1490000,0.05,149,1181687
"6785",34229,-1737,8e+05,0.05,80,1181767
"7196",15800,-3009,2080000,0.001,208,1181975
"6966",26589,-1975,560000,0.05,56,1182031
"6951",26934,-1516,8e+05,0.05,80,1182111
"5674",17419,-1222,560000,0.1,56,1182167
"6853",32661,-1636,1e+06,0.05,100,1182267
"7463",19748,-2067,8e+05,0.001,80,1182347
"6733",14147,-1864,7e+05,0.05,70,1182417
"6718",43742,-1626.5,2690000,0.05,269,1182686
"6039",12572,-1060,8e+05,0.1,80,1182766
"7469",40048,-2573,640000,0.001,64,1182830
"6325",29086,-1238,4040000,0.1,404,1183234
"6656",44468,-1980,1360000,0.05,136,1183370
"6754",35390,-1625,1e+06,0.05,100,1183470
"6631",16687,-1562,490000,0.05,49,1183519
"7475",25635,-2259,7e+05,0.001,70,1183589
"7169",15914,-2763,1190000,0.001,119,1183708
"6721",36222,-1873,5640000,0.05,564,1184272
"6769",13220,-1903,490000,0.05,49,1184321
"6731",14084,-1537,1960000,0.05,196,1184517
"6661",15283,-1905,720000,0.05,72,1184589
"5797",36683,-1068,7e+05,0.1,70,1184659
"6706",14777,-1773,640000,0.05,64,1184723
"7247",14213,-2174,8e+05,0.001,80,1184803
"6340",28390,-1301,490000,0.1,49,1184852
"5676",17546,-1337,490000,0.1,49,1184901
"6745",35519,-1826.5,1120000,0.05,112,1185013
"6642",16348,-1553,7e+05,0.05,70,1185083
"6755",13743,-1547,1260000,0.05,126,1185209
"6516",24071,-1079,8e+05,0.1,80,1185289
"7064",18391,-3379,1e+06,0.001,100,1185389
"5764",36869,-1424,7e+05,0.1,70,1185459
"6554",18230,-1837.5,1260000,0.05,126,1185585
"7276",12052,-3440,8e+05,0.001,80,1185665
"6817",11048,-1883,1440000,0.05,144,1185809
"7466",2553,-2700,630000,0.001,63,1185872
"6992",1426,-1924,8e+05,0.05,80,1185952
"6993",23449,-1771,8e+05,0.05,80,1186032
"7476",25546,-2259,490000,0.001,49,1186081
"6976",26128,-1589,8e+05,0.05,80,1186161
"6542",18600,-1800,1190000,0.05,119,1186280
"7418",27902,-3198,640000,0.001,64,1186344
"7412",5129,-2133,7e+05,0.001,70,1186414
"6112",11128,-1164,560000,0.1,56,1186470
"7262",13148,-2957,7e+05,0.001,70,1186540
"7231",14474,-2447,630000,0.001,63,1186603
"6464",1602,-1032,1e+06,0.1,100,1186703
"6236",32100,-1224,2050000,0.1,205,1186908
"6999",39651,-1814,7e+05,0.05,70,1186978
"6712",14648,-1527,1050000,0.05,105,1187083
"7388",6803,-2066,8e+05,0.001,80,1187163
"6702",14674,-1718,490000,0.05,49,1187212
"6913",29973,-1722,1750000,0.05,175,1187387
"6659",15880,-1735,2960000,0.05,296,1187683
"6839",33181,-1597.5,1630000,0.05,163,1187846
"6984",1707,-1787,1e+06,0.05,100,1187946
"7301",11058,-2007,1e+06,0.001,100,1188046
"6591",37256,-1523,7e+05,0.05,70,1188116
"7283",34275,-2757,560000,0.001,56,1188172
"6652",16006,-1792,1460000,0.05,146,1188318
"7190",15470,-3114.5,1500000,0.001,150,1188468
"5799",15610,-1147,8e+05,0.1,80,1188548
"6663",15416,-1529,1290000,0.05,129,1188677
"7124",17025,-2798,1e+06,0.001,100,1188777
"7302",11091,-2007,3500000,0.001,350,1189127
"6868",32074,-1902,490000,0.05,49,1189176
"7387",29549,-2066,7e+05,0.001,70,1189246
"7277",12053,-3440,7e+05,0.001,70,1189316
"6922",6724,-1996,490000,0.05,49,1189365
"6828",43066,-1806,3110000,0.05,311,1189676
"7000",24902,-1771,2400000,0.05,240,1189916
"6831",10839,-1777,560000,0.05,56,1189972
"7313",10437,-2401,640000,0.001,64,1190036
"6872",32085,-1701,2240000,0.05,224,1190260
"6864",9468,-1689,8e+05,0.05,80,1190340
"7050",18629,-2108,560000,0.001,56,1190396
"6643",36871,-1998,490000,0.05,49,1190445
"7212",36273,-2997,8e+05,0.001,80,1190525
"7071",44137,-2134,640000,0.001,64,1190589
"6764",13674,-1759,2400000,0.05,240,1190829
"7248",43698,-2575,2750000,0.001,275,1191104
"6842",10446,-1851,3860000,0.05,386,1191490
"7069",18411,-2614,640000,0.001,64,1191554
"7496",58,-2387,1e+06,0.001,100,1191654
"6685",15202,-1529,5300000,0.05,530,1192184
"6674",15091,-1595,9e+05,0.05,90,1192274
"6748",35483,-1849,490000,0.05,49,1192323
"7336",32215,-3188,560000,0.001,56,1192379
"6953",26931,-1952,8e+05,0.05,80,1192459
"6716",14348,-1809,8e+05,0.05,80,1192539
"5959",35890,-1131,3690000,0.1,369,1192908
"7367",7934,-2067,640000,0.001,64,1192972
"7381",7388,-3454,7e+05,0.001,70,1193042
"7273",34442,-3240,490000,0.001,49,1193091
"6777",12676,-1869,8e+05,0.05,80,1193171
"7200",43816,-2103,640000,0.001,64,1193235
"7382",7348,-2861,490000,0.001,49,1193284
"7078",37749,-2095,8e+05,0.001,80,1193364
"7284",11868,-2675,560000,0.001,56,1193420
"7342",32173,-3188,7e+05,0.001,70,1193490
"6637",16454,-1547,3760000,0.05,376,1193866
"7034",38326,-2630,3250000,0.001,325,1194191
"7371",7755,-3456,630000,0.001,63,1194254
"7467",2230,-2270,1500000,0.001,150,1194404
"7220",14782,-2508,7e+05,0.001,70,1194474
"7495",38409,-2387,8e+05,0.001,80,1194554
"7459",19845,-2831,1e+06,0.001,100,1194654
"7294",11442,-3252,560000,0.001,56,1194710
"7017",18987,-2092,1e+06,0.001,100,1194810
"7057",18620,-2037.5,2260000,0.001,226,1195036
"7405",5649,-2723,490000,0.001,49,1195085
"7014",38351,-2233,7e+05,0.001,70,1195155
"7359",8268,-2014,560000,0.001,56,1195211
"7103",17773,-2452,4040000,0.001,404,1195615
"7288",34189,-2675,1360000,0.001,136,1195751
"7409",41427,-2024,7e+05,0.001,70,1195821
"7051",18680,-2108,1190000,0.001,119,1195940
"7340",9373,-3500,7e+05,0.001,70,1196010
"7172",44455,-3049,560000,0.001,56,1196066
"7049",18618,-2443,7e+05,0.001,70,1196136
"7116",23333,-2913,490000,0.001,49,1196185
"7155",16271,-2763,8e+05,0.001,80,1196265
"7025",18909,-2928,1e+06,0.001,100,1196365
"7363",8071,-2156,1520000,0.001,152,1196517
"7035",18746,-3274,8e+05,0.001,80,1196597
"7391",6612,-2015,560000,0.001,56,1196653
"7224",14507,-2249,9e+05,0.001,90,1196743
"7360",30980,-2014,630000,0.001,63,1196806
"7044",18711,-2155,1190000,0.001,119,1196925
"7451",20244,-3501,1e+06,0.001,100,1197025
"7097",44015,-2059,720000,0.001,72,1197097
"7193",36676,-2714,560000,0.001,56,1197153
"7316",10463,-2401,720000,0.001,72,1197225
"7456",26868,-2162,1750000,0.001,175,1197400
"7370",42352,-2163,640000,0.001,64,1197464
"7325",32664,-2641,7e+05,0.001,70,1197534
"7221",36242,-2021,2140000,0.001,214,1197748
"7407",5453,-2017,7e+05,0.001,70,1197818
"7118",17171,-2908,560000,0.001,56,1197874
"7281",11926,-2675,490000,0.001,49,1197923
"7031",18880,-3079,8e+05,0.001,80,1198003
"7474",39891,-2448,630000,0.001,63,1198066
"7021",18983,-2233,1360000,0.001,136,1198202
"7286",21562,-2757,640000,0.001,64,1198266
"7154",16163,-2403,8e+05,0.001,80,1198346
"7109",17482,-2862,7e+05,0.001,70,1198416
"7151",16145,-3189,7e+05,0.001,70,1198486
"7081",17841,-2382.5,1430000,0.001,143,1198629
"7093",17849,-2454,630000,0.001,63,1198692
"7217",36179,-2805,1e+06,0.001,100,1198792
"7416",28030,-2155,720000,0.001,72,1198864
"7203",15114,-3326,1e+06,0.001,100,1198964
"7160",16459,-2016,560000,0.001,56,1199020
"7481",23534,-3006,640000,0.001,64,1199084
"7419",27677,-3483,7e+05,0.001,70,1199154
"7142",16893,-2233,3130000,0.001,313,1199467
"7348",9311,-3294,7e+05,0.001,70,1199537
"7483",25111,-3006,560000,0.001,56,1199593
"7094",37356,-3138,9e+05,0.001,90,1199683
"7139",16719,-3336,8e+05,0.001,80,1199763
"7413",41296,-2024,490000,0.001,49,1199812
"7306",10523,-2310,7e+05,0.001,70,1199882
"7040",18841,-3354,1050000,0.001,105,1199987
"7389",6741,-2066,490000,0.001,49,1200036
"7356",23721,-2147,1190000,0.001,119,1200155
"7167",23149,-2860,1260000,0.001,126,1200281
"7219",15000,-2176,490000,0.001,49,1200330
"7123",23322,-2798,7e+05,0.001,70,1200400
"7437",27236,-2242,9e+05,0.001,90,1200490
"7400",6096,-2015,2890000,0.001,289,1200779
"7300",11204,-2007,1190000,0.001,119,1200898
"7265",13330,-2349,7e+05,0.001,70,1200968
"7449",26929,-2675,7e+05,0.001,70,1201038
"7347",32103,-3500,1e+06,0.001,100,1201138
"7307",10665,-2654,1360000,0.001,136,1201274
"7216",15109,-2730,1700000,0.001,170,1201444
"7492",38523,-2110,8e+05,0.001,80,1201524
"7290",11783,-3184,1990000,0.001,199,1201723
"7344",9331,-2739,1e+06,0.001,100,1201823
"7270",34625,-3272,630000,0.001,63,1201886
"7326",10199,-2661,1360000,0.001,136,1202022
"7406",41783,-2267,3550000,0.001,355,1202377
"7428",27750,-3077,3450000,0.001,345,1202722
"7399",6085,-2140,7e+05,0.001,70,1202792
"7091",17800,-2452,720000,0.001,72,1202864
"7339",9406,-3460,560000,0.001,56,1202920
"7373",30548,-3452,490000,0.001,49,1202969
"7037",38249,-2648,490000,0.001,49,1203018
"7085",37462,-2155,640000,0.001,64,1203082
"7055",38182,-2282,560000,0.001,56,1203138
"7150",36820,-3037,7e+05,0.001,70,1203208
"7268",12618,-3272,560000,0.001,56,1203264
"7345",9351,-2739,7e+05,0.001,70,1203334
"7079",17960,-2313,560000,0.001,56,1203390
"7317",10194,-2092,980000,0.001,98,1203488
"7074",44136,-3402,490000,0.001,49,1203537
"7436",4507,-3034,8e+05,0.001,80,1203617
"7415",28010,-2452,630000,0.001,63,1203680
"7183",15767,-3201,7e+05,0.001,70,1203750
"7244",14167,-2578,560000,0.001,56,1203806
"7263",34982,-2957,490000,0.001,49,1203855
"7490",39142,-2535,1360000,0.001,136,1203991
"7206",15344,-2131,2190000,0.001,219,1204210
"7195",36595,-2548,1190000,0.001,119,1204329
"7384",30293,-2291,1890000,0.001,189,1204518
"7177",15997,-2202,490000,0.001,49,1204567
"7140",16670,-3336,7e+05,0.001,70,1204637
"7068",18577,-2280,1800000,0.001,180,1204817
"7393",6453,-2664,640000,0.001,64,1204881
"7180",15688,-2272,7e+05,0.001,70,1204951
"7233",14368,-2110,810000,0.001,81,1205032
"7353",8958,-2221,7e+05,0.001,70,1205102
"7434",27260,-3136,1e+06,0.001,100,1205202
"7191",15646,-2548,640000,0.001,64,1205266
"7149",16531,-2012,1e+06,0.001,100,1205366
"7426",27537,-3233,7e+05,0.001,70,1205436
"7293",11769,-3254,1360000,0.001,136,1205572
"7346",32095,-3460,8e+05,0.001,80,1205652
"7209",14985,-2509,980000,0.001,98,1205750
"7199",36467,-2131,1120000,0.001,112,1205862
"7395",6223,-2027,1120000,0.001,112,1205974
"7029",38298,-3161,7e+05,0.001,70,1206044
"7322",10046,-2245,8e+05,0.001,80,1206124
"7185",15994,-3009,8e+05,0.001,80,1206204
"7022",18963,-2233,1190000,0.001,119,1206323
"7374",8064,-2067,1500000,0.001,150,1206473
"7337",9501,-2739,7e+05,0.001,70,1206543
"7278",34330,-3482,1e+06,0.001,100,1206643
"7127",17119,-3473,1e+06,0.001,100,1206743
"7225",36081,-2249,720000,0.001,72,1206815
"7159",16019,-3049,1e+06,0.001,100,1206915
"7226",14475,-2004,9e+05,0.001,90,1207005
"7133",21911,-3473,7e+05,0.001,70,1207075
"7303",33364,-2197,560000,0.001,56,1207131
"7299",11159,-2573,560000,0.001,56,1207187
"7075",18227,-2285,1e+06,0.001,100,1207287
"7222",14818,-2521,5390000,0.001,539,1207826
"7086",37517,-2454,560000,0.001,56,1207882
"7099",17651,-2452,1200000,0.001,120,1208002
"7479",25421,-2356.5,1270000,0.001,127,1208129
"7208",15123,-3326,7e+05,0.001,70,1208199
"7153",16056,-2860,1e+06,0.001,100,1208299
"7117",17190,-2913,7e+05,0.001,70,1208369
"7335",32204,-3188,490000,0.001,49,1208418
"7365",7970,-2726,640000,0.001,64,1208482
"7156",44462,-3247,7e+05,0.001,70,1208552
"7239",14579,-2508,3060000,0.001,306,1208858
"7446",4172,-2702,7e+05,0.001,70,1208928
"7380",7799,-2861,1190000,0.001,119,1209047
"7252",43662,-2463,1e+06,0.001,100,1209147
"7204",15306,-2072.66666666667,2190000,0.001,219,1209366
"7096",44014,-2059,9e+05,0.001,90,1209456
"7334",9518,-3298,1e+06,0.001,100,1209556
"7098",44013,-2502,630000,0.001,63,1209619
"7114",23365,-2252,630000,0.001,63,1209682
"7256",13547,-2041,7e+05,0.001,70,1209752
"7403",28859,-2199,7e+05,0.001,70,1209822
"7298",33780,-3111,7e+05,0.001,70,1209892
"7494",46,-2387,7e+05,0.001,70,1209962
"7210",15043,-2171.5,3250000,0.001,325,1210287
"7408",28221,-2133,8e+05,0.001,80,1210367
"7341",9657,-2379,1190000,0.001,119,1210486
"7396",6222,-2027,1680000,0.001,168,1210654
"7429",27425,-2796,490000,0.001,49,1210703
"7164",16237,-3037,560000,0.001,56,1210759
"7257",13420,-2658,8e+05,0.001,80,1210839
"7422",27759,-3408.5,1750000,0.001,175,1211014
"7390",6795,-2066,560000,0.001,56,1211070
"7267",12757,-3425,1800000,0.001,180,1211250
"7065",18439,-3379,8e+05,0.001,80,1211330
"7312",10469,-2310,1260000,0.001,126,1211456
"7234",14471,-2233,630000,0.001,63,1211519
"7378",7617,-2203.5,1400000,0.001,140,1211659
"7329",32437,-3483,8e+05,0.001,80,1211739
"7198",15432,-2131,640000,0.001,64,1211803
"7030",18868,-2899,8e+05,0.001,80,1211883
"7178",44432,-2670,490000,0.001,49,1211932
"7269",34806,-3173,2140000,0.001,214,1212146
"7048",38291,-2069,7e+05,0.001,70,1212216
"7042",38282,-2108,1050000,0.001,105,1212321
"7453",40816,-2071,560000,0.001,56,1212377
"7478",1462,-2259,560000,0.001,56,1212433
"7318",10065,-2245,490000,0.001,49,1212482
"7189",15484,-2576.5,2150000,0.001,215,1212697
"7343",32144,-3188,8e+05,0.001,80,1212777
"7368",42364,-2241,8e+05,0.001,80,1212857
"7404",28656,-2208,490000,0.001,49,1212906
"7272",34552,-3419,560000,0.001,56,1212962
"7131",23323,-2245,1920000,0.001,192,1213154
"7080",37680,-2095,560000,0.001,56,1213210
"7015",18986,-2233,1e+06,0.001,100,1213310
"7175",15874,-3201,560000,0.001,56,1213366
"7297",33900,-3252,1890000,0.001,189,1213555
"7375",30731,-2744,560000,0.001,56,1213611
"7485",39199,-2396,8e+05,0.001,80,1213691
"7141",16632,-2670,1e+06,0.001,100,1213791
"7442",27094,-3034,560000,0.001,56,1213847
"7112",17361,-2220,1190000,0.001,119,1213966
"7132",23336,-2632,490000,0.001,49,1214015
"7362",23677,-2047,630000,0.001,63,1214078
"7330",32453,-3298,8e+05,0.001,80,1214158
"7176",36714,-3363,560000,0.001,56,1214214
"7182",15822,-3201,560000,0.001,56,1214270
"7170",44433,-3247,560000,0.001,56,1214326
"7115",17229,-2526,560000,0.001,56,1214382
"7104",17686,-3127,1800000,0.001,180,1214562
"7433",27276,-3039,1e+06,0.001,100,1214662
"7184",15967,-2714,7e+05,0.001,70,1214732
"7424",27557,-2796,7e+05,0.001,70,1214802
"7033",18956,-2335.5,1500000,0.001,150,1214952
"7194",36491,-3263,560000,0.001,56,1215008
"7482",25097,-3006,490000,0.001,49,1215057
"7275",34546,-2187,490000,0.001,49,1215106
"7240",35907,-2046,560000,0.001,56,1215162
"7292",43308,-3254,1e+06,0.001,100,1215262
"7319",42887,-2245,560000,0.001,56,1215318
"7211",15115,-2730,1360000,0.001,136,1215454
"7477",25438,-2259,8e+05,0.001,80,1215534
"7261",34986,-2194,7e+05,0.001,70,1215604
"7355",23727,-2190,560000,0.001,56,1215660
"7023",6,-2052.5,2620000,0.001,262,1215922
"7376",7670,-2291,490000,0.001,49,1215971
"7333",32329,-3483,1e+06,0.001,100,1216071
"7125",21933,-2788,8e+05,0.001,80,1216151
"7089",44079,-2272,8e+05,0.001,80,1216231
"7120",17029,-2744,9e+05,0.001,90,1216321
"7088",17792,-2227,640000,0.001,64,1216385
"7460",3134,-2831,8e+05,0.001,80,1216465
"7119",37125,-2832,2400000,0.001,240,1216705
"7018",38325,-2268,1560000,0.001,156,1216861
"7372",30557,-3452,560000,0.001,56,1216917
"7229",36073,-2724,630000,0.001,63,1216980
"7082",17989,-2313,640000,0.001,64,1217044
"7461",19839,-2067,7e+05,0.001,70,1217114
"7439",4375,-2702,1e+06,0.001,100,1217214
"7072",18299,-3433,560000,0.001,56,1217270
"7053",38292,-2267,3100000,0.001,310,1217580
"7130",23325,-2744,630000,0.001,63,1217643
"7134",23261,-2808,720000,0.001,72,1217715
"7043",18797,-2108,1190000,0.001,119,1217834
"7106",23397,-3172,7e+05,0.001,70,1217904
"7207",15128,-2384,8e+05,0.001,80,1217984
"7171",16124,-3049,1190000,0.001,119,1218103
"7187",15946,-2048,3720000,0.001,372,1218475
"7036",18762,-2563,7e+05,0.001,70,1218545
"7161",16692,-2016,490000,0.001,49,1218594
"7484",25603,-2934,10560000,0.001,1056,1219650
"7148",36853,-2016,7e+05,0.001,70,1219720
"7266",34854,-2630,1190000,0.001,119,1219839
"7056",38189,-3274,1680000,0.001,168,1220007
"7328",32498,-2982,640000,0.001,64,1220071
"7354",31910,-2221,6350000,0.001,635,1220706
"7201",15172,-3080,7e+05,0.001,70,1220776
"7438",4358,-3496,8e+05,0.001,80,1220856
"7271",12711,-2409,2700000,0.001,270,1221126
"7491",38526,-2196,560000,0.001,56,1221182
"7241",43701,-2575,560000,0.001,56,1221238
"7455",26822,-2976,560000,0.001,56,1221294
"7258",35221,-2261,8e+05,0.001,80,1221374
"7411",5169,-2133,560000,0.001,56,1221430
"7432",20656,-3387,7e+05,0.001,70,1221500
"7026",18930,-2715,1500000,0.001,150,1221650
"7016",38352,-2630,1500000,0.001,150,1221800
"7250",14078,-2174,560000,0.001,56,1221856
"7308",10617,-2654,7e+05,0.001,70,1221926
"7254",13715,-2041,1360000,0.001,136,1222062
"7480",23544,-3006,560000,0.001,56,1222118
"7027",18951,-2715,1700000,0.001,170,1222288
"7246",14139,-2046,490000,0.001,49,1222337
"7285",21552,-2757,8e+05,0.001,80,1222417
"7440",27267,-3034,2500000,0.001,250,1222667
"7260",34994,-2894.66666666667,1750000,0.001,175,1222842
"7430",27518,-2796,560000,0.001,56,1222898
"7472",1621,-2447,1e+06,0.001,100,1222998
"7324",9926,-2395,7e+05,0.001,70,1223068
"7305",33745,-2013.5,7020000,0.001,702,1223770
"7489",39150,-2396,1700000,0.001,170,1223940
"7314",33023,-2007,9e+05,0.001,90,1224030
"7255",43584,-2258,7e+05,0.001,70,1224100
"7280",11902,-2675,560000,0.001,56,1224156
"7218",44361,-2529,7e+05,0.001,70,1224226
"7179",15807,-2670,560000,0.001,56,1224282
"7232",36053,-2174,630000,0.001,63,1224345
"7447",27003,-2535,560000,0.001,56,1224401
"7202",43802,-2103,560000,0.001,56,1224457
"7228",36051,-2724,720000,0.001,72,1224529
"7414",28324,-2267,4940000,0.001,494,1225023
"7289",11676,-3254,8e+05,0.001,80,1225103
"7332",32346,-2982,8e+05,0.001,80,1225183
"7192",15882,-2714,1800000,0.001,180,1225363
"7092",37433,-2155,9e+05,0.001,90,1225453
"7061",18415,-2152,1e+06,0.001,100,1225553
"7464",19815,-2635,630000,0.001,63,1225616
"7045",38304,-2404,2400000,0.001,240,1225856
"7181",36674,-2273,490000,0.001,49,1225905
"7168",44445,-2763,560000,0.001,56,1225961
"7253",13465,-3081,7e+05,0.001,70,1226031
"7392",29374,-2015,640000,0.001,64,1226095
"7138",16666,-3099,9e+05,0.001,90,1226185
"7028",18879,-3354,1800000,0.001,180,1226365
"7487",702,-2535,640000,0.001,64,1226429
"7066",18507,-2421,1360000,0.001,136,1226565
"7032",38322,-2404,8e+05,0.001,80,1226645
"7431",4529,-3387,490000,0.001,49,1226694
"7090",44060,-2034,560000,0.001,56,1226750
"7077",38236,-3274,6080000,0.001,608,1227358
"7264",34780,-2957,7e+05,0.001,70,1227428
"7129",17005,-3151,7e+05,0.001,70,1227498
"7486",39185,-2396,560000,0.001,56,1227554
"7394",6344,-2826.5,1260000,0.001,126,1227680
"7377",42309,-3226,560000,0.001,56,1227736
"7058",18767,-2899,4010000,0.001,401,1228137
"7457",3446,-2533,8e+05,0.001,80,1228217
"7443",27107,-2242,630000,0.001,63,1228280
"7435",27253,-3034,7e+05,0.001,70,1228350
"7361",31000,-2047,720000,0.001,72,1228422
"7358",23717,-2190,2140000,0.001,214,1228636
"7427",27413,-3077,560000,0.001,56,1228692
"7425",4694,-3416,7e+05,0.001,70,1228762
"7111",17347,-2683,560000,0.001,56,1228818
"7311",10391,-2007,560000,0.001,56,1228874
"7274",34571,-3240,7e+05,0.001,70,1228944
"7188",15852,-2144,7e+05,0.001,70,1229014
"7488",667,-2396,7e+05,0.001,70,1229084
"7448",4037,-2640,640000,0.001,64,1229148
"7084",17846,-2587.5,1990000,0.001,199,1229347
"7321",9981,-2245,7e+05,0.001,70,1229417
"7083",17998,-2313,1050000,0.001,105,1229522
"7245",14198,-2002,2450000,0.001,245,1229767
"7351",9050,-2221,490000,0.001,49,1229816
"7397",6025,-2604,8e+05,0.001,80,1229896
"7251",35835,-2412,1890000,0.001,189,1230085
"7350",9063,-2061.5,1190000,0.001,119,1230204
"7237",14387,-2578,640000,0.001,64,1230268
"7243",14313,-2670,1500000,0.001,150,1230418
"7052",38197,-3427,560000,0.001,56,1230474
"7137",16910,-3032,8e+05,0.001,80,1230554
"7100",17659,-2302,560000,0.001,56,1230610
"7320",10031,-2395,7e+05,0.001,70,1230680
"7205",15077,-2159,8e+05,0.001,80,1230760
"7158",16044,-3049,8e+05,0.001,80,1230840
"7493",38425,-2387,560000,0.001,56,1230896
"7357",8683,-2190,1360000,0.001,136,1231032
"7402",28993,-2140,1190000,0.001,119,1231151
"7019",38345,-2269,490000,0.001,49,1231200
"7279",12008,-3482,8e+05,0.001,80,1231280
"7046",18654,-2563,560000,0.001,56,1231336
"7369",7857,-2241,560000,0.001,56,1231392
"7259",34967,-2630,490000,0.001,49,1231441
"7062",44145,-2134,8e+05,0.001,80,1231521
"7458",27303,-3039,1.3e+07,0.001,1300,1232821
"7102",17638,-2540,560000,0.001,56,1232877
"7214",14885,-2469,1560000,0.001,156,1233033
"7067",18385,-2280,640000,0.001,64,1233097
"7338",9378,-2739,490000,0.001,49,1233146
"7113",37067,-2099,7e+05,0.001,70,1233216
"7323",9918,-2395,1e+06,0.001,100,1233316
"7145",16347,-2670,7e+05,0.001,70,1233386
"7465",2982,-2355,8e+05,0.001,80,1233466
"7020",18975,-2168,7e+05,0.001,70,1233536
"7282",34228,-2757,7e+05,0.001,70,1233606
"7310",10440,-2007,8e+05,0.001,80,1233686
"7441",27112,-3034,490000,0.001,49,1233735
"7450",27038,-2464,1400000,0.001,140,1233875
"7223",14761,-2176,560000,0.001,56,1233931
"7121",17220,-2037.33333333333,2200000,0.001,220,1234151
"7157",44459,-3247,8e+05,0.001,80,1234231
"7417",27966,-2039,8e+05,0.001,80,1234311
"7470",1722,-2389,7e+05,0.001,70,1234381
"7070",18344,-2152,8e+05,0.001,80,1234461
"7047",18734,-2563,1190000,0.001,119,1234580
"7136",23249,-2632,640000,0.001,64,1234644
"7128",17015,-3151,8e+05,0.001,80,1234724
"7230",35987,-2187,9e+05,0.001,90,1234814
"7420",20741,-2006,490000,0.001,49,1234863
"7227",14515,-2004,720000,0.001,72,1234935
"7385",30461,-2203.5,5600000,0.001,560,1235495
"7215",36282,-2917,8e+05,0.001,80,1235575
"7238",36070,-2447,2090000,0.001,209,1235784
"7364",42388,-2149,9e+05,0.001,90,1235874
"7087",17853,-2101,560000,0.001,56,1235930
"7146",16515,-2670,560000,0.001,56,1235986
"7421",27606,-3189,1e+06,0.001,100,1236086
"7291",11743,-2006,560000,0.001,56,1236142
"7468",40225,-2379,7e+05,0.001,70,1236212
"7242",35903,-2055,2650000,0.001,265,1236477
"7186",15826,-2118,9e+05,0.001,90,1236567
"7295",11547,-3252,490000,0.001,49,1236616
"7147",44495,-3024,490000,0.001,49,1236665
"7059",18548,-2614,7e+05,0.001,70,1236735
"7410",5259,-2024,8e+05,0.001,80,1236815
"7383",7404,-2861,7e+05,0.001,70,1236885
"7304",33417,-2197,8e+05,0.001,80,1236965
"7197",15343,-2744,9e+05,0.001,90,1237055
"7041",18792,-3161,1190000,0.001,119,1237174
"7349",32251,-2261,1050000,0.001,105,1237279
"7309",10500,-2591,1360000,0.001,136,1237415
"7444",4342,-3496,7e+05,0.001,70,1237485
"7445",4211,-3496,560000,0.001,56,1237541
"7165",15894,-3189,490000,0.001,49,1237590
"7235",14335,-2575,560000,0.001,56,1237646
"7143",16759,-2648,630000,0.001,63,1237709
"7386",7186,-2652,8e+05,0.001,80,1237789
"7105",17374,-2862,1e+06,0.001,100,1237889
"7101",17658,-2302,640000,0.001,64,1237953
"7315",10305,-2007,630000,0.001,63,1238016
"7352",9075,-2221,560000,0.001,56,1238072
"7423",4962,-3184,8e+05,0.001,80,1238152
"7236",35939,-2620,560000,0.001,56,1238208
"7213",14832,-2186.5,1900000,0.001,190,1238398
"7173",44428,-3049,7e+05,0.001,70,1238468
"7152",16116,-3189,1e+06,0.001,100,1238568
"7174",15878,-3377,490000,0.001,49,1238617
"7039",44158,-2715,560000,0.001,56,1238673
"7122",23354,-2526,1700000,0.001,170,1238843
"7108",17412,-2683,8e+05,0.001,80,1238923
"7110",23375,-3172,7e+05,0.001,70,1238993
"7331",9545,-2982,7e+05,0.001,70,1239063
"7038",38229,-2069,7e+05,0.001,70,1239133
"7076",18295,-2842,1190000,0.001,119,1239252
"7163",16564,-3037,490000,0.001,49,1239301
"7162",36804,-2012,490000,0.001,49,1239350
"7473",1500,-2934,560000,0.001,56,1239406
