"","gridcode_vec","prob_vec","area_vec","area_ha","cum_area_ha"
"1",38334,0.9,1050000,105,105
"3",18762,0.9,7e+05,70,175
"8",18734,0.9,1190000,119,294
"11",18816,0.8,1260000,126,420
"13",38293,0.7,4490000,449,869
"14",18587,0.7,1490000,149,1018
"17",38187,0.7,1890000,189,1207
"20",37999,0.9,560000,56,1263
"29",18589,0.7,5030000,503,1766
"30",18350,0.8,1800000,180,1946
"32",18223,0.7,1500000,150,2096
"38",37725,0.9,1e+06,100,2196
"40",37578,0.9,7e+05,70,2266
"42",17942,0.9,7e+05,70,2336
"43",44130,0.9,2650000,265,2601
"45",37768,0.7,1390000,139,2740
"47",18304,0.7,1890000,189,2929
"51",44091,0.9,490000,49,2978
"52",17998,0.9,1050000,105,3083
"54",37769,0.7,3830000,383,3466
"57",44087,0.9,1200000,120,3586
"59",17783,0.9,1200000,120,3706
"60",37459,0.9,630000,63,3769
"62",37520,0.9,2890000,289,4058
"63",37276,0.9,720000,72,4130
"64",37278,0.9,8e+05,80,4210
"65",37265,0.9,560000,56,4266
"72",37275,0.566666666666667,8990000,899,5165
"73",37193,0.9,8e+05,80,5245
"75",17374,0.9,1e+06,100,5345
"76",43983,0.9,1e+06,100,5445
"77",17490,0.9,1700000,170,5615
"80",37232,0.6,2920000,292,5907
"81",17402,0.7,1190000,119,6026
"85",17361,0.9,1190000,119,6145
"89",17358,0.9,1e+06,100,6245
"92",37136,0.9,7e+05,70,6315
"94",37057,0.9,7e+05,70,6385
"98",37025,0.766666666666667,1990000,199,6584
"101",17128,0.9,560000,56,6640
"103",37310,0.7,7330000,733,7373
"105",17257,0.8,1850000,185,7558
"106",23249,0.9,640000,64,7622
"107",36965,0.9,2140000,214,7836
"109",36899,0.9,7e+05,70,7906
"116",36906,0.9,7e+05,70,7976
"119",16651,0.8,1560000,156,8132
"125",16116,0.9,1e+06,100,8232
"130",15894,0.9,490000,49,8281
"138",16140,0.9,560000,56,8337
"141",15753,0.9,560000,56,8393
"144",16293,0.9,6700000,670,9063
"146",43913,0.8,3480000,348,9411
"148",44413,0.9,1e+06,100,9511
"151",23097,0.9,720000,72,9583
"156",36538,0.9,9e+05,90,9673
"158",43879,0.8,2190000,219,9892
"168",44385,0.9,560000,56,9948
"169",15143,0.9,1260000,126,10074
"172",44388,0.9,490000,49,10123
"179",14999,0.9,630000,63,10186
"190",14976,0.9,3060000,306,10492
"191",36239,0.9,1500000,150,10642
"196",43771,0.633333333333333,1750000,175,10817
"200",14849,0.9,560000,56,10873
"201",36310,0.7,980000,98,10971
"208",14628,0.9,490000,49,11020
"209",44369,0.8,1490000,149,11169
"211",14743,0.8,1260000,126,11295
"212",36111,0.9,720000,72,11367
"214",14478,0.7,5070000,507,11874
"220",43729,0.9,8e+05,80,11954
"222",14462,0.9,9e+05,90,12044
"223",21657,0.9,720000,72,12116
"229",14197,0.5,980000,98,12214
"230",14269,0.6,1360000,136,12350
"231",14277,0.5,2680000,268,12618
"239",14041,0.9,7e+05,70,12688
"241",14036,0.7,1960000,196,12884
"245",21643,0.9,1e+06,100,12984
"248",35463,0.9,560000,56,13040
"250",13772,0.9,560000,56,13096
"251",13874,0.7,6560000,656,13752
"265",13740,0.8,5890000,589,14341
"266",35431,0.9,8e+05,80,14421
"269",35433,0.766666666666667,2130000,213,14634
"271",35203,0.9,1e+06,100,14734
"280",13156,0.9,8e+05,80,14814
"282",35038,0.766666666666667,5260000,526,15340
"284",23083,0.9,560000,56,15396
"298",35127,0.8,3380000,338,15734
"304",12780,0.9,640000,64,15798
"322",23758,0.6,2360000,236,16034
"329",23753,0.9,1750000,175,16209
"330",34668,0.6,2820000,282,16491
"331",12261,0.9,1050000,105,16596
"341",12213,0.8,1120000,112,16708
"344",11914,0.8,3600000,360,17068
"347",34151,0.9,2e+06,200,17268
"361",43181,0.9,1e+06,100,17368
"364",43259,0.58,6680000,668,18036
"374",33761,0.9,490000,49,18085
"377",33899,0.6,1850000,185,18270
"378",33950,0.6,2680000,268,18538
"380",21521,0.9,6140000,614,19152
"389",43170,0.5,2820000,282,19434
"390",43166,0.9,1500000,150,19584
"392",11116,0.7,1700000,170,19754
"394",10997,0.5,2920000,292,20046
"400",33364,0.9,560000,56,20102
"405",33431,0.9,490000,49,20151
"409",10899,0.9,8e+05,80,20231
"410",21431,0.9,1e+06,100,20331
"412",10780,0.8,2170000,217,20548
"414",43087,0.6,1540000,154,20702
"415",33329,0.8,1990000,199,20901
"419",10517,0.9,7e+05,70,20971
"425",33062,0.6,2140000,214,21185
"428",10369,0.8,1760000,176,21361
"430",33209,0.6,12810000,1281,22642
"436",32772,0.9,7e+05,70,22712
"441",32935,0.7,9210000,921,23633
"443",21389,0.8,3840000,384,24017
"446",10163,0.6,2400000,240,24257
"451",21374,0.9,490000,49,24306
"453",9968,0.8,1750000,175,24481
"455",10043,0.9,490000,49,24530
"459",32639,0.9,8e+05,80,24610
"466",10096,0.9,560000,56,24666
"467",32667,0.5,3700000,370,25036
"468",42894,0.7,3990000,399,25435
"474",9659,0.9,560000,56,25491
"476",9655,0.8,1360000,136,25627
"477",9900,0.8,1930000,193,25820
"480",32296,0.9,490000,49,25869
"496",42750,0.5,5800000,580,26449
"500",9209,0.566666666666667,3760000,376,26825
"501",9180,0.6,3060000,306,27131
"502",32010,0.8,2520000,252,27383
"507",32692,0.5,18330000,1833,29216
"512",9441,0.9,560000,56,29272
"518",9223,0.366666666666667,3330000,333,29605
"522",8745,0.9,640000,64,29669
"527",31239,0.8,2970000,297,29966
"530",8742,0.8,1600000,160,30126
"533",42508,0.6,1330000,133,30259
"535",31235,0.9,1190000,119,30378
"537",31135,0.766666666666667,4420000,442,30820
"543",42400,0.9,2890000,289,31109
"544",30886,0.9,630000,63,31172
"551",7617,0.6,1400000,140,31312
"554",23035,0.9,7e+05,70,31382
"556",21186,0.9,8e+05,80,31462
"559",7606,0.8,1500000,150,31612
"564",30459,0.9,6020000,602,32214
"565",29633,0.9,7e+05,70,32284
"566",29844,0.9,7e+05,70,32354
"567",21176,0.9,560000,56,32410
"570",42190,0.7,4910000,491,32901
"572",6643,0.9,2060000,206,33107
"573",6508,0.9,7e+05,70,33177
"576",29259,0.9,1750000,175,33352
"580",6739,0.8,1190000,119,33471
"581",6170,0.9,1750000,175,33646
"582",42178,0.7,2750000,275,33921
"593",42043,0.9,490000,49,33970
"597",6157,0.6,2760000,276,34246
"598",28944,0.9,1800000,180,34426
"601",23034,0.9,1360000,136,34562
"607",42193,0.557142857142857,9340000,934,35496
"612",28758,0.9,720000,72,35568
"616",5960,0.8,1340000,134,35702
"624",28881,0.9,3760000,376,36078
"631",28526,0.9,1190000,119,36197
"635",28524,0.9,8e+05,80,36277
"640",28536,0.8,1400000,140,36417
"641",28376,0.9,8e+05,80,36497
"649",28377,0.9,560000,56,36553
"650",28327,0.9,7e+05,70,36623
"651",28558,0.9,3110000,311,36934
"652",23019,0.9,1360000,136,37070
"653",28300,0.9,560000,56,37126
"657",5305,0.9,7e+05,70,37196
"672",21019,0.9,1e+06,100,37296
"675",5473,0.7,1890000,189,37485
"685",5739,0.766666666666667,1990000,199,37684
"690",28118,0.9,640000,64,37748
"691",28063,0.9,8e+05,80,37828
"692",28056,0.9,8e+05,80,37908
"701",41782,0.8,1440000,144,38052
"709",27983,0.9,630000,63,38115
"718",20950,0.9,9e+05,90,38205
"727",27875,0.9,8e+05,80,38285
"729",28043,0.9,2810000,281,38566
"759",4982,0.9,490000,49,38615
"761",41457,0.766666666666667,4790000,479,39094
"762",41096,0.9,8e+05,80,39174
"767",27759,0.8,1750000,175,39349
"768",4962,0.9,8e+05,80,39429
"771",27557,0.9,7e+05,70,39499
"787",4953,0.9,490000,49,39548
"792",4694,0.9,7e+05,70,39618
"794",27413,0.9,560000,56,39674
"813",27236,0.9,9e+05,90,39764
"815",41321,0.8,2160000,216,39980
"832",27094,0.9,560000,56,40036
"833",27115,0.9,560000,56,40092
"856",27014,0.9,640000,64,40156
"860",27064,0.9,640000,64,40220
"861",22987,0.9,8e+05,80,40300
"876",3999,0.9,8e+05,80,40380
"906",26850,0.9,630000,63,40443
"935",26776,0.9,1e+06,100,40543
"963",22961,0.9,2550000,255,40798
"964",3563,0.9,560000,56,40854
"986",22927,0.9,560000,56,40910
"1040",19839,0.9,7e+05,70,40980
"1042",26470,0.9,640000,64,41044
"1071",3558,0.7,1280000,128,41172
"1073",26424,0.9,9e+05,90,41262
"1074",3339,0.8,1360000,136,41398
"1089",4957,0.9,1260000,126,41524
"1117",2942,0.9,560000,56,41580
"1118",22852,0.9,630000,63,41643
"1145",22763,0.9,9e+05,90,41733
"1155",26309,0.9,9e+05,90,41823
"1174",26328,0.9,7e+05,70,41893
"1188",2750,0.9,560000,56,41949
"1189",26280,0.9,630000,63,42012
"1207",19536,0.9,8e+05,80,42092
"1249",2747,0.9,720000,72,42164
"1250",22680,0.9,2090000,209,42373
"1265",40424,0.9,630000,63,42436
"1271",26229,0.9,810000,81,42517
"1286",2350,0.9,810000,81,42598
"1289",26240,0.9,560000,56,42654
"1290",19400,0.9,640000,64,42718
"1306",26205,0.9,720000,72,42790
"1307",26264,0.9,1990000,199,42989
"1310",2299,0.9,560000,56,43045
"1319",19369,0.766666666666667,2630000,263,43308
"1320",2549,0.9,2140000,214,43522
"1325",2252,0.9,7e+05,70,43592
"1341",40272,0.9,560000,56,43648
"1348",40371,0.8,1340000,134,43782
"1360",40229,0.9,7e+05,70,43852
"1361",40226,0.9,490000,49,43901
"1362",40219,0.9,7e+05,70,43971
"1380",40193,0.9,7e+05,70,44041
"1393",26211,0.8,3750000,375,44416
"1396",26111,0.9,7e+05,70,44486
"1403",26104,0.9,490000,49,44535
"1418",26101,0.8,2960000,296,44831
"1427",22341,0.9,8e+05,80,44911
"1432",19010,0.9,7e+05,70,44981
"1435",2082,0.9,560000,56,45037
"1436",1924,0.9,8e+05,80,45117
"1437",22299,0.9,640000,64,45181
"1444",1869,0.9,560000,56,45237
"1446",1918,0.9,640000,64,45301
"1447",40120,0.6,2200000,220,45521
"1448",22286,0.9,560000,56,45577
"1455",25921,0.8,2190000,219,45796
"1490",25593,0.9,8e+05,80,45876
"1507",1449,0.9,7e+05,70,45946
"1511",39840,0.9,640000,64,46010
"1523",25158,0.9,560000,56,46066
"1530",22149,0.9,1530000,153,46219
"1532",25265,0.7,2630000,263,46482
"1534",39730,0.9,490000,49,46531
"1535",39749,0.9,7e+05,70,46601
"1543",25043,0.9,8e+05,80,46681
"1548",25060,0.9,490000,49,46730
"1550",22119,0.9,490000,49,46779
"1567",24492,0.7,1280000,128,46907
"1571",24338,0.9,720000,72,46979
"1572",39677,0.6,1460000,146,47125
"1577",790,0.9,640000,64,47189
"1580",39386,0.6,6320000,632,47821
"1596",18987,0.7,1e+06,100,47921
"1597",38318,0.7,8e+05,80,48001
"1598",18956,0.5,1500000,150,48151
"1600",1,0.342857142857143,10480000,1048,49199
"1602",38255,0.7,7e+05,70,49269
"1603",18769,0.7,560000,56,49325
"1604",38323,0.7,1530000,153,49478
"1605",38205,0.6,1260000,126,49604
"1606",18702,0.7,1050000,105,49709
"1607",38209,0.7,1560000,156,49865
"1608",38291,0.7,7e+05,70,49935
"1609",38189,0.7,1680000,168,50103
"1611",18636,0.7,7e+05,70,50173
"1612",38123,0.7,1700000,170,50343
"1613",38055,0.7,1e+06,100,50443
"1614",44145,0.7,8e+05,80,50523
"1615",18705,0.7,640000,64,50587
"1616",38037,0.7,640000,64,50651
"1617",44137,0.7,640000,64,50715
"1618",38095,0.6,1360000,136,50851
"1619",18530,0.7,7e+05,70,50921
"1620",38031,0.7,1990000,199,51120
"1621",18358,0.7,490000,49,51169
"1622",44128,0.7,560000,56,51225
"1623",38091,0.5,5090000,509,51734
"1624",38236,0.7,6080000,608,52342
"1625",18140,0.7,1e+06,100,52442
"1626",18100,0.7,1e+06,100,52542
"1627",37835,0.7,1050000,105,52647
"1628",37870,0.6,1560000,156,52803
"1629",18293,0.7,490000,49,52852
"1630",37800,0.7,560000,56,52908
"1631",37708,0.7,560000,56,52964
"1632",18403,0.7,630000,63,53027
"1633",18383,0.7,1290000,129,53156
"1634",18072,0.7,560000,56,53212
"1635",37781,0.7,2190000,219,53431
"1636",44105,0.7,7e+05,70,53501
"1637",37873,0.7,2890000,289,53790
"1638",18046,0.566666666666667,2090000,209,53999
"1639",37956,0.7,3600000,360,54359
"1640",37687,0.7,1700000,170,54529
"1641",37566,0.7,1e+06,100,54629
"1642",44112,0.7,1700000,170,54799
"1643",44119,0.7,1360000,136,54935
"1644",17960,0.7,560000,56,54991
"1647",17936,0.7,7e+05,70,55061
"1648",37541,0.7,7e+05,70,55131
"1649",17834,0.7,560000,56,55187
"1650",17780,0.7,7e+05,70,55257
"1651",17989,0.7,640000,64,55321
"1652",17846,0.5,1990000,199,55520
"1653",17786,0.7,8e+05,80,55600
"1654",17813,0.7,8e+05,80,55680
"1655",17893,0.7,1610000,161,55841
"1656",37457,0.566666666666667,1990000,199,56040
"1657",17801,0.633333333333333,3520000,352,56392
"1658",17734,0.7,560000,56,56448
"1659",17771,0.7,640000,64,56512
"1660",37376,0.7,1190000,119,56631
"1661",37303,0.7,9e+05,90,56721
"1662",17594,0.7,630000,63,56784
"1663",17616,0.7,720000,72,56856
"1664",44015,0.7,720000,72,56928
"1665",44013,0.7,630000,63,56991
"1666",17808,0.6,2630000,263,57254
"1667",37434,0.7,640000,64,57318
"1668",37204,0.6,2160000,216,57534
"1669",17479,0.6,1440000,144,57678
"1670",17531,0.7,640000,64,57742
"1671",43980,0.7,640000,64,57806
"1672",37224,0.7,1e+06,100,57906
"1673",17563,0.5,2340000,234,58140
"1674",17542,0.566666666666667,2700000,270,58410
"1675",37181,0.7,9e+05,90,58500
"1677",23397,0.7,7e+05,70,58570
"1678",17366,0.7,1e+06,100,58670
"1679",17412,0.7,8e+05,80,58750
"1680",17456,0.7,8e+05,80,58830
"1681",44010,0.7,1700000,170,59000
"1682",17430,0.633333333333333,1540000,154,59154
"1683",37212,0.5,1500000,150,59304
"1684",37170,0.7,560000,56,59360
"1685",17463,0.7,560000,56,59416
"1686",23400,0.7,630000,63,59479
"1687",23404,0.7,1190000,119,59598
"1688",17482,0.7,7e+05,70,59668
"1689",23375,0.7,7e+05,70,59738
"1690",17347,0.7,560000,56,59794
"1691",17329,0.7,7e+05,70,59864
"1692",21967,0.7,560000,56,59920
"1693",17363,0.7,7e+05,70,59990
"1694",17461,0.7,1680000,168,60158
"1695",17280,0.7,490000,49,60207
"1696",17283,0.6,1750000,175,60382
"1697",17139,0.7,7e+05,70,60452
"1698",17445,0.7,1120000,112,60564
"1699",17141,0.7,490000,49,60613
"1700",23333,0.7,490000,49,60662
"1701",17190,0.7,7e+05,70,60732
"1702",21952,0.7,560000,56,60788
"1705",37064,0.7,8e+05,80,60868
"1706",17207,0.7,7e+05,70,60938
"1707",17168,0.7,8e+05,80,61018
"1708",37100,0.7,2500000,250,61268
"1709",37041,0.7,7e+05,70,61338
"1710",37012,0.7,8e+05,80,61418
"1711",17220,0.633333333333333,2200000,220,61638
"1712",23322,0.7,7e+05,70,61708
"1713",17025,0.7,1e+06,100,61808
"1714",21933,0.7,8e+05,80,61888
"1715",21934,0.7,7e+05,70,61958
"1716",17119,0.7,1e+06,100,62058
"1717",37020,0.7,560000,56,62114
"1718",17213,0.7,2360000,236,62350
"1719",23325,0.7,630000,63,62413
"1720",23323,0.7,1920000,192,62605
"1722",21911,0.7,7e+05,70,62675
"1724",43947,0.7,640000,64,62739
"1725",37084,0.633333333333333,2850000,285,63024
"1726",36929,0.5,3090000,309,63333
"1727",16802,0.7,560000,56,63389
"1728",17138,0.7,1200000,120,63509
"1729",37026,0.7,2750000,275,63784
"1730",23335,0.7,1200000,120,63904
"1731",23261,0.7,720000,72,63976
"1732",23253,0.7,640000,64,64040
"1733",16929,0.7,8e+05,80,64120
"1734",23275,0.7,560000,56,64176
"1737",16910,0.7,8e+05,80,64256
"1739",17047,0.7,2060000,206,64462
"1740",17125,0.5,2200000,220,64682
"1741",16785,0.7,1e+06,100,64782
"1742",36907,0.7,1500000,150,64932
"1743",36972,0.4,2640000,264,65196
"1744",36936,0.5,2300000,230,65426
"1745",36902,0.7,1800000,180,65606
"1746",23234,0.7,8e+05,80,65686
"1747",16666,0.7,9e+05,90,65776
"1748",16719,0.7,8e+05,80,65856
"1752",16632,0.7,1e+06,100,65956
"1754",16669,0.7,630000,63,66019
"1755",36806,0.7,1260000,126,66145
"1756",16771,0.7,560000,56,66201
"1757",16759,0.7,630000,63,66264
"1760",43942,0.7,560000,56,66320
"1761",16347,0.7,7e+05,70,66390
"1762",16515,0.7,560000,56,66446
"1764",36924,0.5,2050000,205,66651
"1765",16786,0.7,1190000,119,66770
"1766",16708,0.7,2400000,240,67010
"1767",36934,0.6,4530000,453,67463
"1771",16145,0.7,7e+05,70,67533
"1772",16348,0.7,7e+05,70,67603
"1773",16163,0.7,8e+05,80,67683
"1774",21792,0.7,1e+06,100,67783
"1775",16488,0.7,8e+05,80,67863
"1778",16271,0.7,8e+05,80,67943
"1780",36893,0.7,7e+05,70,68013
"1782",36871,0.7,490000,49,68062
"1783",36750,0.433333333333333,1820000,182,68244
"1784",36754,0.7,3450000,345,68589
"1785",16117,0.6,1190000,119,68708
"1786",36777,0.7,1260000,126,68834
"1787",23148,0.7,2190000,219,69053
"1788",23142,0.6,2890000,289,69342
"1790",43923,0.7,7e+05,70,69412
"1791",23149,0.7,1260000,126,69538
"1793",44445,0.7,560000,56,69594
"1794",36714,0.7,560000,56,69650
"1795",15999,0.7,630000,63,69713
"1796",23104,0.7,490000,49,69762
"1799",43886,0.7,490000,49,69811
"1800",43880,0.7,7e+05,70,69881
"1801",16273,0.7,490000,49,69930
"1802",36674,0.7,490000,49,69979
"1803",15822,0.7,560000,56,70035
"1804",15994,0.7,8e+05,80,70115
"1805",16168,0.7,2060000,206,70321
"1806",16155,0.7,2190000,219,70540
"1807",15665,0.7,1e+06,100,70640
"1808",16071,0.7,7e+05,70,70710
"1809",36784,0.433333333333333,2820000,282,70992
"1810",15727,0.5,2820000,282,71274
"1811",15603,0.7,8e+05,80,71354
"1812",43936,0.7,8e+05,80,71434
"1813",44415,0.7,1190000,119,71553
"1814",44468,0.7,1360000,136,71689
"1815",44397,0.7,1e+06,100,71789
"1816",15493,0.7,7e+05,70,71859
"1817",21760,0.7,7e+05,70,71929
"1818",43871,0.7,640000,64,71993
"1819",44395,0.7,1440000,144,72137
"1820",15642,0.6,1200000,120,72257
"1821",44409,0.6,1290000,129,72386
"1822",15565,0.7,1520000,152,72538
"1823",16127,0.366666666666667,3040000,304,72842
"1824",15632,0.5,1460000,146,72988
"1825",15504,0.5,1460000,146,73134
"1826",43857,0.7,1190000,119,73253
"1827",15399,0.5,1910000,191,73444
"1828",15743,0.7,1530000,153,73597
"1829",15464,0.7,720000,72,73669
"1830",15414,0.7,1520000,152,73821
"1831",36470,0.5,1990000,199,74020
"1832",36647,0.566666666666667,3720000,372,74392
"1833",15803,0.7,2890000,289,74681
"1834",15311,0.7,640000,64,74745
"1835",15570,0.5,1360000,136,74881
"1836",15339,0.7,8e+05,80,74961
"1837",15394,0.7,2340000,234,75195
"1838",43819,0.7,1800000,180,75375
"1839",44380,0.633333333333333,2340000,234,75609
"1840",15239,0.7,560000,56,75665
"1841",15282,0.566666666666667,2200000,220,75885
"1842",15296,0.566666666666667,2750000,275,76160
"1843",36396,0.7,1190000,119,76279
"1844",43845,0.4,3960000,396,76675
"1846",15278,0.7,1050000,105,76780
"1847",44386,0.7,1260000,126,76906
"1848",44375,0.7,490000,49,76955
"1851",15198,0.7,1700000,170,77125
"1852",15033,0.5,1260000,126,77251
"1853",36295,0.6,1290000,129,77380
"1854",14929,0.7,7e+05,70,77450
"1855",36343,0.7,1800000,180,77630
"1856",15128,0.7,8e+05,80,77710
"1857",15159,0.7,2500000,250,77960
"1858",36390,0.5,1260000,126,78086
"1860",15130,0.7,2550000,255,78341
"1861",36539,0.38,7770000,777,79118
"1862",15202,0.7,5300000,530,79648
"1863",36260,0.5,1260000,126,79774
"1864",14878,0.65,2540000,254,80028
"1865",36285,0.7,3200000,320,80348
"1866",36205,0.7,1050000,105,80453
"1867",14881,0.7,7e+05,70,80523
"1868",14858,0.7,2750000,275,80798
"1869",14803,0.7,1750000,175,80973
"1870",14744,0.7,490000,49,81022
"1871",36407,0.3,2780000,278,81300
"1872",14809,0.7,1e+06,100,81400
"1873",14854,0.7,8e+05,80,81480
"1874",36257,0.5,1460000,146,81626
"1875",36272,0.7,8e+05,80,81706
"1876",14943,0.7,4060000,406,82112
"1877",36216,0.7,1360000,136,82248
"1878",14737,0.7,7e+05,70,82318
"1880",36236,0.7,1700000,170,82488
"1881",14851,0.7,490000,49,82537
"1882",36150,0.7,1050000,105,82642
"1883",14912,0.6,1050000,105,82747
"1884",14825,0.7,560000,56,82803
"1885",36114,0.6,1260000,126,82929
"1886",14742,0.5,2460000,246,83175
"1887",43737,0.7,7e+05,70,83245
"1889",14663,0.7,560000,56,83301
"1890",36225,0.7,1750000,175,83476
"1891",36005,0.7,8e+05,80,83556
"1892",36091,0.7,560000,56,83612
"1893",21681,0.7,8e+05,80,83692
"1894",44349,0.7,560000,56,83748
"1895",14404,0.7,1200000,120,83868
"1896",44357,0.7,2690000,269,84137
"1898",14817,0.7,4540000,454,84591
"1899",14699,0.7,3760000,376,84967
"1900",35949,0.5,2080000,208,85175
"1901",35977,0.5,2810000,281,85456
"1902",14575,0.7,3620000,362,85818
"1903",43694,0.7,9e+05,90,85908
"1904",14471,0.7,630000,63,85971
"1905",14289,0.7,640000,64,86035
"1906",14567,0.7,8e+05,80,86115
"1907",14329,0.7,560000,56,86171
"1908",35969,0.7,560000,56,86227
"1909",36084,0.35,5690000,569,86796
"1910",14609,0.3,5940000,594,87390
"1911",14338,0.5,2060000,206,87596
"1912",14287,0.4,1690000,169,87765
"1913",14321,0.7,2060000,206,87971
"1914",14266,0.7,3200000,320,88291
"1915",14107,0.7,560000,56,88347
"1916",35816,0.5,1500000,150,88497
"1917",44320,0.7,8e+05,80,88577
"1918",14442,0.4,3210000,321,88898
"1919",13943,0.7,490000,49,88947
"1920",13956,0.7,560000,56,89003
"1921",43725,0.35,18350000,1835,90838
"1922",35773,0.6,3840000,384,91222
"1923",35693,0.7,3390000,339,91561
"1924",13961,0.7,1050000,105,91666
"1925",23802,0.7,560000,56,91722
"1926",35696,0.7,1700000,170,91892
"1927",43633,0.7,1e+06,100,91992
"1928",14033,0.566666666666667,3260000,326,92318
"1929",13860,0.7,7e+05,70,92388
"1930",14239,0.433333333333333,5020000,502,92890
"1931",43637,0.7,1050000,105,92995
"1932",13812,0.6,3260000,326,93321
"1933",35686,0.5,1050000,105,93426
"1934",14031,0.7,2060000,206,93632
"1935",23799,0.7,2960000,296,93928
"1937",13775,0.7,560000,56,93984
"1938",13997,0.5,2310000,231,94215
"1939",13927,0.7,1360000,136,94351
"1940",13883,0.6,1490000,149,94500
"1941",13703,0.5,1500000,150,94650
"1942",13631,0.7,1e+06,100,94750
"1943",13468,0.6,1560000,156,94906
"1944",13749,0.7,1890000,189,95095
"1945",35355,0.34,7700000,770,95865
"1946",43610,0.7,3260000,326,96191
"1947",43589,0.7,1190000,119,96310
"1948",13589,0.7,490000,49,96359
"1949",35590,0.7,3860000,386,96745
"1950",13742,0.5,1500000,150,96895
"1951",35348,0.7,2890000,289,97184
"1952",13398,0.5,1560000,156,97340
"1953",35186,0.633333333333333,2680000,268,97608
"1954",13329,0.7,7e+05,70,97678
"1955",23789,0.7,7e+05,70,97748
"1957",35471,0.5,1600000,160,97908
"1958",35535,0.7,12040000,1204,99112
"1959",13082,0.7,7e+05,70,99182
"1960",13104,0.7,1e+06,100,99282
"1962",13918,0.5,1190000,119,99401
"1963",35206,0.6,2360000,236,99637
"1964",35054,0.7,1190000,119,99756
"1965",13201,0.7,560000,56,99812
"1967",35071,0.7,5030000,503,100315
"1968",13236,0.7,560000,56,100371
"1969",13148,0.7,7e+05,70,100441
"1970",34982,0.7,490000,49,100490
"1971",13644,0.357142857142857,13850000,1385,101875
"1972",35065,0.633333333333333,4790000,479,102354
"1975",34994,0.433333333333333,1750000,175,102529
"1976",13182,0.633333333333333,2690000,269,102798
"1977",34780,0.7,7e+05,70,102868
"1980",35033,0.7,1700000,170,103038
"1981",12611,0.7,1e+06,100,103138
"1982",34818,0.4,5750000,575,103713
"1983",35005,0.7,9e+05,90,103803
"1984",12555,0.7,8e+05,80,103883
"1986",34750,0.6,1360000,136,104019
"1987",35086,0.7,8040000,804,104823
"1988",12465,0.5,3600000,360,105183
"1989",12685,0.7,9e+05,90,105273
"1990",34612,0.7,630000,63,105336
"1991",12409,0.7,720000,72,105408
"1992",34633,0.7,1990000,199,105607
"1993",34645,0.6,2330000,233,105840
"1994",23751,0.7,9e+05,90,105930
"1995",12310,0.7,720000,72,106002
"1996",12764,0.3,7910000,791,106793
"1997",12589,0.7,1990000,199,106992
"1998",43455,0.7,8e+05,80,107072
"1999",34512,0.7,2e+06,200,107272
"2000",12943,0.5,3090000,309,107581
"2001",34486,0.7,2140000,214,107795
"2002",34461,0.7,7e+05,70,107865
"2004",12269,0.566666666666667,7900000,790,108655
"2005",12016,0.7,560000,56,108711
"2006",34388,0.7,560000,56,108767
"2007",12484,0.5,1720000,172,108939
"2008",34310,0.7,1700000,170,109109
"2009",12412,0.42,4410000,441,109550
"2010",34321,0.7,2500000,250,109800
"2011",12084,0.7,1750000,175,109975
"2012",34217,0.7,490000,49,110024
"2013",11849,0.7,560000,56,110080
"2014",34418,0.6,10320000,1032,111112
"2015",34304,0.7,490000,49,111161
"2016",34133,0.633333333333333,3610000,361,111522
"2017",34577,0.6,1680000,168,111690
"2018",21561,0.7,7e+05,70,111760
"2019",34090,0.7,560000,56,111816
"2020",12002,0.7,490000,49,111865
"2021",11856,0.5,1280000,128,111993
"2022",11841,0.7,640000,64,112057
"2023",34074,0.6,1360000,136,112193
"2024",34294,0.633333333333333,7540000,754,112947
"2025",34483,0.7,5660000,566,113513
"2026",11771,0.566666666666667,2070000,207,113720
"2027",43315,0.7,8e+05,80,113800
"2028",11756,0.5,1500000,150,113950
"2029",43298,0.6,3120000,312,114262
"2030",11764,0.7,9e+05,90,114352
"2031",34128,0.7,720000,72,114424
"2032",11832,0.7,1620000,162,114586
"2033",11710,0.6,1270000,127,114713
"2034",43339,0.7,1350000,135,114848
"2035",11605,0.7,9e+05,90,114938
"2036",11991,0.6,3400000,340,115278
"2037",11614,0.633333333333333,2540000,254,115532
"2038",34026,0.7,1700000,170,115702
"2039",11844,0.6,1600000,160,115862
"2040",43320,0.65,3270000,327,116189
"2041",11954,0.5,2260000,226,116415
"2042",11562,0.433333333333333,3170000,317,116732
"2043",11597,0.7,3350000,335,117067
"2045",11592,0.6,3100000,310,117377
"2047",34003,0.5,1360000,136,117513
"2048",21527,0.633333333333333,2160000,216,117729
"2049",21517,0.7,1e+06,100,117829
"2050",43201,0.7,1500000,150,117979
"2051",33975,0.7,6160000,616,118595
"2052",33838,0.7,7e+05,70,118665
"2053",11762,0.5,1720000,172,118837
"2054",11442,0.7,560000,56,118893
"2055",11547,0.7,490000,49,118942
"2056",23081,0.7,560000,56,118998
"2057",34040,0.5,1200000,120,119118
"2058",11320,0.7,560000,56,119174
"2059",43167,0.5,1050000,105,119279
"2060",33848,0.7,1190000,119,119398
"2061",11368,0.7,7e+05,70,119468
"2062",33818,0.7,560000,56,119524
"2063",11367,0.7,490000,49,119573
"2064",11425,0.7,630000,63,119636
"2065",43192,0.5,2260000,226,119862
"2066",11692,0.7,560000,56,119918
"2067",11326,0.7,7e+05,70,119988
"2068",21503,0.5,1260000,126,120114
"2069",11618,0.5,1560000,156,120270
"2070",33781,0.7,1120000,112,120382
"2071",11260,0.433333333333333,2170000,217,120599
"2073",43150,0.7,1750000,175,120774
"2074",21510,0.6,1500000,150,120924
"2075",11278,0.7,2330000,233,121157
"2076",33766,0.7,1190000,119,121276
"2077",33611,0.7,1e+06,100,121376
"2078",11318,0.5,1600000,160,121536
"2079",33753,0.6,4950000,495,122031
"2080",33628,0.4,1400000,140,122171
"2081",11159,0.7,560000,56,122227
"2082",11563,0.5,2260000,226,122453
"2083",21482,0.7,560000,56,122509
"2084",33912,0.5,6450000,645,123154
"2085",33557,0.7,630000,63,123217
"2086",11125,0.7,7e+05,70,123287
"2087",43138,0.7,490000,49,123336
"2088",21480,0.7,8e+05,80,123416
"2089",33488,0.7,1e+06,100,123516
"2090",11069,0.7,7e+05,70,123586
"2091",10970,0.7,1e+06,100,123686
"2092",10993,0.7,8e+05,80,123766
"2093",33919,0.4,5960000,596,124362
"2094",33942,0.5,7980000,798,125160
"2095",11144,0.7,2770000,277,125437
"2096",33594,0.7,560000,56,125493
"2097",11014,0.7,8e+05,80,125573
"2098",10922,0.5,2340000,234,125807
"2100",10885,0.6,1260000,126,125933
"2101",33577,0.433333333333333,2920000,292,126225
"2102",33303,0.5,1850000,185,126410
"2103",33414,0.7,7e+05,70,126480
"2104",33601,0.7,4550000,455,126935
"2105",43066,0.7,3110000,311,127246
"2106",33257,0.7,7e+05,70,127316
"2107",33376,0.7,560000,56,127372
"2108",33971,0.5,5230000,523,127895
"2109",11007,0.5,2240000,224,128119
"2110",43007,0.633333333333333,1990000,199,128318
"2111",33180,0.7,8e+05,80,128398
"2112",33275,0.7,8e+05,80,128478
"2113",33155,0.7,1800000,180,128658
"2114",33179,0.7,7e+05,70,128728
"2115",10661,0.5,1520000,152,128880
"2116",44309,0.5,6360000,636,129516
"2117",42999,0.7,1190000,119,129635
"2118",10642,0.7,640000,64,129699
"2119",33213,0.5,5680000,568,130267
"2120",10584,0.5,4790000,479,130746
"2121",33264,0.6,3460000,346,131092
"2122",44316,0.5,2930000,293,131385
"2123",42939,0.7,560000,56,131441
"2125",42937,0.7,560000,56,131497
"2126",10300,0.6,1920000,192,131689
"2127",10253,0.7,1190000,119,131808
"2128",10406,0.5,1290000,129,131937
"2129",42948,0.7,2400000,240,132177
"2130",10322,0.5,1360000,136,132313
"2131",32966,0.7,1900000,190,132503
"2132",10493,0.366666666666667,2790000,279,132782
"2134",10241,0.7,8e+05,80,132862
"2135",10111,0.6,3500000,350,133212
"2136",44301,0.7,2750000,275,133487
"2137",42903,0.7,4880000,488,133975
"2138",10108,0.7,490000,49,134024
"2139",10165,0.7,490000,49,134073
"2140",10180,0.6,1560000,156,134229
"2141",32863,0.7,2550000,255,134484
"2142",21384,0.7,1e+06,100,134584
"2143",10068,0.7,8e+05,80,134664
"2144",21392,0.7,1700000,170,134834
"2145",23068,0.7,4750000,475,135309
"2146",10078,0.5,2e+06,200,135509
"2147",10010,0.7,1260000,126,135635
"2148",21390,0.7,1750000,175,135810
"2149",32710,0.7,490000,49,135859
"2150",32681,0.7,490000,49,135908
"2151",32647,0.7,560000,56,135964
"2152",21375,0.7,640000,64,136028
"2153",32674,0.7,1500000,150,136178
"2154",9931,0.7,560000,56,136234
"2155",9987,0.5,1990000,199,136433
"2156",32631,0.5,4560000,456,136889
"2157",32734,0.7,2750000,275,137164
"2158",32802,0.7,1690000,169,137333
"2160",32586,0.7,1900000,190,137523
"2162",21398,0.7,6e+06,600,138123
"2163",32669,0.7,8e+05,80,138203
"2164",32671,0.7,2900000,290,138493
"2165",32549,0.4,5780000,578,139071
"2166",32415,0.7,1e+06,100,139171
"2167",32509,0.5,2360000,236,139407
"2168",42890,0.7,2890000,289,139696
"2169",21353,0.7,560000,56,139752
"2170",9782,0.7,490000,49,139801
"2171",42811,0.5,9180000,918,140719
"2172",9703,0.5,1950000,195,140914
"2173",32261,0.7,560000,56,140970
"2174",9485,0.7,490000,49,141019
"2175",9497,0.7,1e+06,100,141119
"2176",9315,0.7,8e+05,80,141199
"2177",32407,0.6,1260000,126,141325
"2178",32306,0.7,2400000,240,141565
"2179",42824,0.7,3810000,381,141946
"2180",9536,0.7,630000,63,142009
"2181",9155,0.7,7e+05,70,142079
"2182",9156,0.5,2260000,226,142305
"2183",23058,0.7,1190000,119,142424
"2184",21365,0.7,6730000,673,143097
"2185",32136,0.4,1760000,176,143273
"2186",42780,0.6,1560000,156,143429
"2187",9255,0.7,7e+05,70,143499
"2188",31927,0.5,1820000,182,143681
"2189",31909,0.5,2140000,214,143895
"2190",42753,0.7,1700000,170,144065
"2191",21328,0.7,1200000,120,144185
"2192",32601,0.7,16190000,1619,145804
"2193",31707,0.7,7e+05,70,145874
"2194",31870,0.5,4450000,445,146319
"2195",9099,0.7,7e+05,70,146389
"2197",21310,0.7,1190000,119,146508
"2198",8894,0.5,3460000,346,146854
"2199",31679,0.7,7e+05,70,146924
"2200",23727,0.7,560000,56,146980
"2201",23721,0.7,1190000,119,147099
"2202",8840,0.6,1900000,190,147289
"2203",8683,0.7,1360000,136,147425
"2204",23700,0.7,560000,56,147481
"2205",8442,0.7,8e+05,80,147561
"2206",23695,0.7,640000,64,147625
"2207",31652,0.7,2060000,206,147831
"2208",42600,0.4,1820000,182,148013
"2209",31161,0.5,2260000,226,148239
"2210",8470,0.7,8e+05,80,148319
"2211",8243,0.7,9e+05,90,148409
"2212",42432,0.7,9e+05,90,148499
"2213",42507,0.5,2170000,217,148716
"2214",8501,0.7,1360000,136,148852
"2215",21265,0.6,1120000,112,148964
"2217",31016,0.7,8e+05,80,149044
"2218",31051,0.433333333333333,4420000,442,149486
"2220",30963,0.7,4120000,412,149898
"2221",30916,0.7,9e+05,90,149988
"2222",42388,0.7,9e+05,90,150078
"2223",30878,0.7,1360000,136,150214
"2224",8025,0.6,1340000,134,150348
"2225",21272,0.7,8e+05,80,150428
"2226",31203,0.7,13200000,1320,151748
"2227",30837,0.566666666666667,4510000,451,152199
"2228",30565,0.7,560000,56,152255
"2229",42473,0.3,2550000,255,152510
"2230",7372,0.7,8e+05,80,152590
"2231",30770,0.7,3950000,395,152985
"2232",30888,0.7,6800000,680,153665
"2233",8356,0.3,5390000,539,154204
"2234",8102,0.7,2890000,289,154493
"2235",30480,0.7,1500000,150,154643
"2236",21190,0.7,7e+05,70,154713
"2237",7395,0.7,560000,56,154769
"2238",21208,0.7,6190000,619,155388
"2240",7186,0.7,8e+05,80,155468
"2241",8026,0.7,1e+06,100,155568
"2242",30285,0.7,1990000,199,155767
"2243",7089,0.7,3060000,306,156073
"2244",42246,0.433333333333333,2290000,229,156302
"2245",7331,0.7,490000,49,156351
"2247",8127,0.7,7e+05,70,156421
"2248",21203,0.7,6e+06,600,157021
"2249",29856,0.7,1260000,126,157147
"2250",30478,0.5,2890000,289,157436
"2251",30042,0.7,560000,56,157492
"2252",42209,0.7,640000,64,157556
"2253",29544,0.7,8e+05,80,157636
"2254",29387,0.7,1800000,180,157816
"2255",6744,0.7,560000,56,157872
"2256",6857,0.7,1e+06,100,157972
"2257",7023,0.566666666666667,3180000,318,158290
"2258",29483,0.633333333333333,3310000,331,158621
"2259",29926,0.7,1260000,126,158747
"2260",30220,0.35,6540000,654,159401
"2261",42182,0.7,8e+05,80,159481
"2262",6564,0.5,1530000,153,159634
"2263",6592,0.7,8e+05,80,159714
"2264",29487,0.7,1800000,180,159894
"2265",29429,0.5,10660000,1066,160960
"2266",29292,0.7,7e+05,70,161030
"2267",42174,0.5,1750000,175,161205
"2268",21132,0.7,7e+05,70,161275
"2269",6637,0.7,7e+05,70,161345
"2270",44287,0.7,630000,63,161408
"2271",6392,0.7,560000,56,161464
"2272",6661,0.5,3570000,357,161821
"2273",6633,0.433333333333333,2050000,205,162026
"2274",29376,0.7,2380000,238,162264
"2275",6344,0.5,1260000,126,162390
"2276",21093,0.7,1190000,119,162509
"2277",29122,0.7,2190000,219,162728
"2278",29220,0.7,2820000,282,163010
"2279",29611,0.433333333333333,8730000,873,163883
"2280",6144,0.7,1700000,170,164053
"2281",42067,0.7,1e+06,100,164153
"2282",28984,0.7,7e+05,70,164223
"2283",28964,0.7,490000,49,164272
"2284",21096,0.7,7e+05,70,164342
"2285",6102,0.7,1190000,119,164461
"2286",29074,0.7,1850000,185,164646
"2287",42055,0.7,560000,56,164702
"2288",42181,0.633333333333333,1890000,189,164891
"2289",6096,0.6,2890000,289,165180
"2290",42086,0.7,7e+05,70,165250
"2291",6090,0.5,1990000,199,165449
"2293",28865,0.7,1800000,180,165629
"2294",28923,0.7,2190000,219,165848
"2295",42062,0.7,1e+06,100,165948
"2296",5996,0.7,1500000,150,166098
"2297",42126,0.5,4e+06,400,166498
"2299",28859,0.7,7e+05,70,166568
"2300",28977,0.5,4490000,449,167017
"2301",28805,0.7,8e+05,80,167097
"2302",41909,0.7,560000,56,167153
"2303",28722,0.7,1200000,120,167273
"2304",41907,0.5,4600000,460,167733
"2305",6030,0.6,3240000,324,168057
"2306",5895,0.7,560000,56,168113
"2307",29041,0.433333333333333,6920000,692,168805
"2308",42046,0.7,7e+05,70,168875
"2309",28819,0.7,7e+05,70,168945
"2310",41995,0.7,2490000,249,169194
"2311",28777,0.7,7e+05,70,169264
"2312",5769,0.5,1500000,150,169414
"2313",42060,0.5,4900000,490,169904
"2314",6049,0.7,1800000,180,170084
"2315",28752,0.7,6320000,632,170716
"2316",28437,0.7,1e+06,100,170816
"2317",28532,0.7,1e+06,100,170916
"2318",28387,0.7,7e+05,70,170986
"2319",28680,0.6,1990000,199,171185
"2320",41701,0.7,1e+06,100,171285
"2321",21040,0.7,7e+05,70,171355
"2322",23021,0.7,3690000,369,171724
"2323",5533,0.7,490000,49,171773
"2324",41594,0.7,7e+05,70,171843
"2326",21001,0.5,4410000,441,172284
"2327",41676,0.5,3960000,396,172680
"2328",42085,0.7,4620000,462,173142
"2329",28268,0.7,8e+05,80,173222
"2330",23011,0.7,1e+06,100,173322
"2331",28503,0.5,3830000,383,173705
"2332",28252,0.7,1e+06,100,173805
"2333",41548,0.7,1e+06,100,173905
"2334",5566,0.6,3450000,345,174250
"2336",5320,0.7,2200000,220,174470
"2337",5279,0.7,1e+06,100,174570
"2338",41728,0.7,1190000,119,174689
"2339",21005,0.7,1700000,170,174859
"2340",41682,0.7,2360000,236,175095
"2341",28213,0.7,1260000,126,175221
"2342",28189,0.7,7e+05,70,175291
"2343",5317,0.7,490000,49,175340
"2344",5267,0.7,630000,63,175403
"2345",41342,0.7,630000,63,175466
"2346",28178,0.5,2260000,226,175692
"2347",41433,0.7,640000,64,175756
"2348",28319,0.5,5190000,519,176275
"2349",5401,0.566666666666667,2310000,231,176506
"2350",28067,0.7,560000,56,176562
"2351",28083,0.7,1360000,136,176698
"2352",5369,0.7,1460000,146,176844
"2353",41506,0.6,1640000,164,177008
"2354",20951,0.7,720000,72,177080
"2355",41504,0.7,1360000,136,177216
"2356",28070,0.7,720000,72,177288
"2357",28007,0.7,9e+05,90,177378
"2358",28066,0.7,630000,63,177441
"2359",28018,0.7,720000,72,177513
"2360",28010,0.7,630000,63,177576
"2361",28000,0.7,720000,72,177648
"2362",41249,0.7,630000,63,177711
"2364",41187,0.7,720000,72,177783
"2365",28037,0.7,560000,56,177839
"2366",27868,0.7,640000,64,177903
"2367",27866,0.7,560000,56,177959
"2368",27902,0.7,640000,64,178023
"2369",27858,0.7,8e+05,80,178103
"2370",27910,0.7,560000,56,178159
"2371",5134,0.7,640000,64,178223
"2372",27862,0.7,640000,64,178287
"2373",28122,0.7,3520000,352,178639
"2374",41179,0.7,640000,64,178703
"2375",20911,0.7,640000,64,178767
"2376",41126,0.7,640000,64,178831
"2377",5298,0.5,3470000,347,179178
"2378",27677,0.7,7e+05,70,179248
"2379",41159,0.7,1050000,105,179353
"2380",41137,0.7,7e+05,70,179423
"2381",20739,0.7,7e+05,70,179493
"2382",4858,0.7,560000,56,179549
"2383",20741,0.7,490000,49,179598
"2384",41335,0.5,2820000,282,179880
"2385",27767,0.7,7e+05,70,179950
"2386",28267,0.7,14990000,1499,181449
"2387",27678,0.7,8e+05,80,181529
"2388",27606,0.7,1e+06,100,181629
"2389",27560,0.7,8e+05,80,181709
"2390",41063,0.7,9e+05,90,181799
"2391",4813,0.7,7e+05,70,181869
"2392",20949,0.633333333333333,6730000,673,182542
"2393",4825,0.7,1e+06,100,182642
"2395",41204,0.366666666666667,1920000,192,182834
"2396",41035,0.7,1190000,119,182953
"2397",4854,0.7,490000,49,183002
"2398",27485,0.7,560000,56,183058
"2399",27564,0.7,1190000,119,183177
"2400",27537,0.7,7e+05,70,183247
"2401",27750,0.7,3450000,345,183592
"2402",27425,0.7,490000,49,183641
"2403",4722,0.7,490000,49,183690
"2407",40886,0.7,7e+05,70,183760
"2408",4915,0.7,8e+05,80,183840
"2409",4645,0.7,7e+05,70,183910
"2410",4704,0.6,2760000,276,184186
"2411",27287,0.6,1360000,136,184322
"2412",27260,0.7,1e+06,100,184422
"2413",27253,0.7,7e+05,70,184492
"2414",4507,0.7,8e+05,80,184572
"2415",40903,0.7,1700000,170,184742
"2416",40915,0.7,7e+05,70,184812
"2417",40932,0.7,1e+06,100,184912
"2419",4358,0.7,8e+05,80,184992
"2421",4489,0.566666666666667,1850000,185,185177
"2422",27582,0.7,8200000,820,185997
"2423",27401,0.7,1360000,136,186133
"2425",27267,0.7,2500000,250,186383
"2426",27112,0.7,490000,49,186432
"2427",27107,0.7,630000,63,186495
"2428",27123,0.7,490000,49,186544
"2429",20504,0.7,7e+05,70,186614
"2430",4409,0.7,560000,56,186670
"2431",4342,0.7,7e+05,70,186740
"2432",4211,0.7,560000,56,186796
"2433",4172,0.7,7e+05,70,186866
"2434",27003,0.7,560000,56,186922
"2435",26999,0.7,720000,72,186994
"2436",4390,0.7,640000,64,187058
"2437",4047,0.7,8e+05,80,187138
"2438",4037,0.7,640000,64,187202
"2442",26929,0.7,7e+05,70,187272
"2443",26934,0.7,8e+05,80,187352
"2444",27038,0.6,1400000,140,187492
"2445",26931,0.7,8e+05,80,187572
"2446",26928,0.7,9e+05,90,187662
"2447",26923,0.7,8e+05,80,187742
"2448",20364,0.7,1e+06,100,187842
"2449",20295,0.7,8e+05,80,187922
"2453",20244,0.7,1e+06,100,188022
"2455",40763,0.7,560000,56,188078
"2456",4171,0.6,2690000,269,188347
"2457",26839,0.7,560000,56,188403
"2458",26822,0.7,560000,56,188459
"2459",26837,0.7,560000,56,188515
"2464",40728,0.7,1e+06,100,188615
"2465",26970,0.7,3250000,325,188940
"2466",40749,0.7,8e+05,80,189020
"2467",40759,0.7,7e+05,70,189090
"2468",40733,0.7,7e+05,70,189160
"2469",26800,0.7,1700000,170,189330
"2475",3446,0.7,8e+05,80,189410
"2478",27884,0.5,20870000,2087,191497
"2479",22958,0.7,560000,56,191553
"2480",40760,0.7,7e+05,70,191623
"2481",40768,0.7,490000,49,191672
"2482",3664,0.7,560000,56,191728
"2483",40921,0.7,7e+05,70,191798
"2484",4580,0.5,1850000,185,191983
"2485",26718,0.7,7e+05,70,192053
"2489",26801,0.7,4060000,406,192459
"2490",3365,0.7,7e+05,70,192529
"2491",3402,0.7,560000,56,192585
"2492",26725,0.7,490000,49,192634
"2493",26598,0.7,1430000,143,192777
"2494",26646,0.7,490000,49,192826
"2495",40663,0.7,560000,56,192882
"2496",22989,0.7,490000,49,192931
"2497",26589,0.7,560000,56,192987
"2498",3690,0.7,1360000,136,193123
"2499",3238,0.7,8e+05,80,193203
"2500",22940,0.7,1e+06,100,193303
"2501",40654,0.7,1e+06,100,193403
"2502",40644,0.7,8e+05,80,193483
"2503",3187,0.7,1e+06,100,193583
"2504",19845,0.7,1e+06,100,193683
"2505",3134,0.7,8e+05,80,193763
"2506",26572,0.7,8e+05,80,193843
"2507",26676,0.6,2800000,280,194123
"2508",26458,0.7,8e+05,80,194203
"2509",26447,0.7,560000,56,194259
"2510",3896,0.7,560000,56,194315
"2511",19810,0.7,560000,56,194371
"2512",5013,0.433333333333333,4730000,473,194844
"2513",3381,0.7,720000,72,194916
"2514",22915,0.7,2890000,289,195205
"2515",19903,0.7,4260000,426,195631
"2516",3118,0.7,1360000,136,195767
"2517",2953,0.7,8e+05,80,195847
"2518",22863,0.7,8e+05,80,195927
"2519",40617,0.7,1700000,170,196097
"2520",40595,0.7,640000,64,196161
"2521",22881,0.7,1190000,119,196280
"2522",26416,0.7,560000,56,196336
"2525",22809,0.7,560000,56,196392
"2526",2888,0.7,7e+05,70,196462
"2527",22823,0.7,1260000,126,196588
"2528",2911,0.7,1500000,150,196738
"2529",26402,0.7,1700000,170,196908
"2530",26371,0.7,8e+05,80,196988
"2531",26379,0.7,7e+05,70,197058
"2532",19694,0.5,2050000,205,197263
"2533",2854,0.7,7e+05,70,197333
"2534",22811,0.7,8e+05,80,197413
"2535",2836,0.7,1e+06,100,197513
"2536",26358,0.7,2760000,276,197789
"2537",2837,0.7,1e+06,100,197889
"2538",2723,0.7,8e+05,80,197969
"2542",19674,0.7,1190000,119,198088
"2543",2918,0.7,490000,49,198137
"2544",26387,0.5,1260000,126,198263
"2545",2844,0.7,560000,56,198319
"2546",19668,0.7,560000,56,198375
"2547",26338,0.7,490000,49,198424
"2548",26343,0.7,490000,49,198473
"2549",2793,0.7,1700000,170,198643
"2551",19638,0.7,8e+05,80,198723
"2552",40505,0.7,1430000,143,198866
"2553",40618,0.7,5200000,520,199386
"2554",2903,0.5,2500000,250,199636
"2555",40507,0.7,560000,56,199692
"2556",22711,0.7,640000,64,199756
"2557",26397,0.7,8310000,831,200587
"2558",26249,0.7,560000,56,200643
"2559",2812,0.7,1500000,150,200793
"2560",26308,0.7,1920000,192,200985
"2561",2668,0.7,630000,63,201048
"2562",22655,0.7,9e+05,90,201138
"2563",40422,0.7,9e+05,90,201228
"2564",40430,0.7,720000,72,201300
"2565",26248,0.7,1190000,119,201419
"2566",19410,0.7,8e+05,80,201499
"2567",40454,0.7,8e+05,80,201579
"2568",2373,0.7,8e+05,80,201659
"2569",40433,0.7,560000,56,201715
"2570",40394,0.7,8e+05,80,201795
"2571",19405,0.7,640000,64,201859
"2572",26208,0.7,8e+05,80,201939
"2573",2330,0.7,2950000,295,202234
"2574",2355,0.5,6240000,624,202858
"2575",19408,0.5,2910000,291,203149
"2576",26210,0.5,1260000,126,203275
"2577",26245,0.6,2920000,292,203567
"2578",40392,0.7,1500000,150,203717
"2580",40340,0.7,7e+05,70,203787
"2581",40418,0.7,8e+05,80,203867
"2582",2267,0.7,8e+05,80,203947
"2583",40355,0.7,1e+06,100,204047
"2584",19363,0.7,2050000,205,204252
"2585",2384,0.4,1890000,189,204441
"2586",40399,0.7,3690000,369,204810
"2587",40291,0.7,490000,49,204859
"2588",2236,0.7,630000,63,204922
"2589",40337,0.7,560000,56,204978
"2590",2242,0.7,490000,49,205027
"2591",40300,0.7,7e+05,70,205097
"2592",22454,0.7,560000,56,205153
"2593",40278,0.7,490000,49,205202
"2596",26204,0.7,4250000,425,205627
"2597",2180,0.7,560000,56,205683
"2598",40260,0.7,7e+05,70,205753
"2599",26159,0.7,560000,56,205809
"2600",40458,0.5,3960000,396,206205
"2601",40209,0.5,1750000,175,206380
"2602",40239,0.7,7e+05,70,206450
"2603",40205,0.7,560000,56,206506
"2604",40202,0.7,490000,49,206555
"2605",40225,0.7,7e+05,70,206625
"2606",19368,0.7,490000,49,206674
"2607",26148,0.7,560000,56,206730
"2608",2249,0.55,3760000,376,207106
"2609",2060,0.7,560000,56,207162
"2610",2050,0.7,560000,56,207218
"2611",26151,0.7,490000,49,207267
"2612",26193,0.7,4740000,474,207741
"2613",40168,0.7,8e+05,80,207821
"2614",2098,0.7,2400000,240,208061
"2615",1933,0.7,7e+05,70,208131
"2616",19009,0.7,8e+05,80,208211
"2617",19026,0.7,7e+05,70,208281
"2618",26085,0.7,1800000,180,208461
"2619",1938,0.7,1e+06,100,208561
"2620",26041,0.7,8e+05,80,208641
"2621",1903,0.7,1200000,120,208761
"2622",26051,0.7,1440000,144,208905
"2623",22415,0.7,1500000,150,209055
"2624",40151,0.433333333333333,2600000,260,209315
"2625",26105,0.7,7e+05,70,209385
"2626",26029,0.7,1690000,169,209554
"2628",22270,0.7,1e+06,100,209654
"2629",22264,0.7,8e+05,80,209734
"2630",25975,0.7,1990000,199,209933
"2631",39962,0.7,490000,49,209982
"2632",1664,0.6,1260000,126,210108
"2633",25885,0.7,1700000,170,210278
"2634",25954,0.7,1360000,136,210414
"2635",39955,0.7,560000,56,210470
"2636",1710,0.7,490000,49,210519
"2637",25815,0.7,1190000,119,210638
"2638",1816,0.366666666666667,2300000,230,210868
"2639",1621,0.7,1e+06,100,210968
"2640",25880,0.7,9e+05,90,211058
"2641",1829,0.4,2260000,226,211284
"2642",25570,0.7,560000,56,211340
"2643",25729,0.7,560000,56,211396
"2644",1463,0.7,490000,49,211445
"2647",1426,0.7,8e+05,80,211525
"2648",25506,0.7,560000,56,211581
"2649",39826,0.7,2160000,216,211797
"2650",39835,0.7,640000,64,211861
"2651",39844,0.7,8e+05,80,211941
"2652",1419,0.7,560000,56,211997
"2653",25381,0.7,1530000,153,212150
"2654",25796,0.5,6320000,632,212782
"2655",25389,0.7,720000,72,212854
"2656",23534,0.7,640000,64,212918
"2657",25137,0.7,640000,64,212982
"2658",39801,0.7,640000,64,213046
"2659",1292,0.533333333333333,4990000,499,213545
"2660",25089,0.7,7e+05,70,213615
"2661",25049,0.7,490000,49,213664
"2662",1251,0.7,7e+05,70,213734
"2663",39746,0.7,560000,56,213790
"2664",39758,0.7,1190000,119,213909
"2665",1644,0.7,1750000,175,214084
"2666",39703,0.7,8e+05,80,214164
"2667",39716,0.7,1e+06,100,214264
"2668",39720,0.7,7e+05,70,214334
"2669",39704,0.7,1e+06,100,214434
"2670",39673,0.7,1050000,105,214539
"2671",39687,0.7,7e+05,70,214609
"2672",24871,0.7,560000,56,214665
"2673",1231,0.7,7e+05,70,214735
"2674",1174,0.6,1260000,126,214861
"2675",25316,0.7,1360000,136,214997
"2676",25119,0.45,6340000,634,215631
"2677",39622,0.7,7e+05,70,215701
"2678",22073,0.7,1e+06,100,215801
"2679",22018,0.7,490000,49,215850
"2680",1020,0.5,1290000,129,215979
"2681",39539,0.7,560000,56,216035
"2682",24707,0.7,3300000,330,216365
"2683",24680,0.7,3390000,339,216704
"2684",24742,0.6,1900000,190,216894
"2685",39625,0.7,1190000,119,217013
"2686",911,0.7,630000,63,217076
"2687",39208,0.7,560000,56,217132
"2688",39105,0.7,8e+05,80,217212
"2689",24329,0.7,1e+06,100,217312
"2690",24266,0.7,7e+05,70,217382
"2691",24276,0.7,560000,56,217438
"2692",24248,0.7,490000,49,217487
"2693",24262,0.7,1610000,161,217648
"2694",38973,0.7,1190000,119,217767
"2695",38974,0.7,1700000,170,217937
"2696",39054,0.5,2200000,220,218157
"2697",24220,0.7,1750000,175,218332
"2698",38836,0.7,8e+05,80,218412
"2699",38753,0.7,8e+05,80,218492
"2700",331,0.7,560000,56,218548
"2701",343,0.7,490000,49,218597
"2702",38325,0.4,1560000,156,218753
"2703",38345,0.5,490000,49,218802
"2704",18966,0.5,1960000,196,218998
"2705",38337,0.366666666666667,4500000,450,219448
"2706",38330,0.5,1700000,170,219618
"2707",18746,0.5,8e+05,80,219698
"2708",38249,0.5,490000,49,219747
"2709",18876,0.5,490000,49,219796
"2710",38317,0.5,560000,56,219852
"2711",18818,0.4,1050000,105,219957
"2712",18954,0.4,1290000,129,220086
"2713",18958,0.5,490000,49,220135
"2714",38300,0.5,2360000,236,220371
"2718",38178,0.5,7e+05,70,220441
"2720",38208,0.5,1190000,119,220560
"2721",38292,0.5,3100000,310,220870
"2722",18863,0.5,560000,56,220926
"2724",38182,0.5,560000,56,220982
"2725",38115,0.5,560000,56,221038
"2726",38166,0.5,1e+06,100,221138
"2727",38213,0.5,2550000,255,221393
"2728",18600,0.5,1190000,119,221512
"2729",38093,0.5,8e+05,80,221592
"2730",18915,0.4,1560000,156,221748
"2731",18399,0.5,8e+05,80,221828
"2732",18415,0.5,1e+06,100,221928
"2733",18445,0.5,7e+05,70,221998
"2734",18391,0.5,1e+06,100,222098
"2735",18439,0.5,8e+05,80,222178
"2736",18554,0.5,640000,64,222242
"2737",18574,0.5,8e+05,80,222322
"2738",37967,0.5,560000,56,222378
"2739",37963,0.5,560000,56,222434
"2740",18344,0.5,8e+05,80,222514
"2741",18299,0.5,560000,56,222570
"2742",18392,0.5,1190000,119,222689
"2743",38058,0.4,1750000,175,222864
"2744",38090,0.5,2e+06,200,223064
"2745",18565,0.5,490000,49,223113
"2746",37976,0.5,2700000,270,223383
"2747",18366,0.5,490000,49,223432
"2748",44136,0.5,490000,49,223481
"2749",18246,0.5,1700000,170,223651
"2750",38078,0.5,8e+05,80,223731
"2751",18503,0.5,2750000,275,224006
"2752",18477,0.5,2500000,250,224256
"2753",38305,0.5,16830000,1683,225939
"2754",18317,0.5,1e+06,100,226039
"2755",37791,0.5,7e+05,70,226109
"2756",18174,0.5,8e+05,80,226189
"2757",18230,0.4,1260000,126,226315
"2758",37782,0.5,7e+05,70,226385
"2759",37928,0.4,3550000,355,226740
"2760",18258,0.5,1190000,119,226859
"2761",38149,0.5,7140000,714,227573
"2762",37728,0.5,490000,49,227622
"2763",38009,0.5,4170000,417,228039
"2764",37698,0.5,560000,56,228095
"2765",37993,0.5,5370000,537,228632
"2766",37749,0.5,8e+05,80,228712
"2767",18146,0.5,8e+05,80,228792
"2768",18115,0.5,1e+06,100,228892
"2769",37767,0.5,1360000,136,229028
"2770",18179,0.5,2890000,289,229317
"2771",37862,0.4,2190000,219,229536
"2772",37756,0.4,1440000,144,229680
"2773",18010,0.5,1e+06,100,229780
"2774",37809,0.5,1890000,189,229969
"2775",18065,0.5,7e+05,70,230039
"2776",44098,0.5,1e+06,100,230139
"2777",18077,0.5,7e+05,70,230209
"2778",18036,0.5,560000,56,230265
"2779",18104,0.5,2260000,226,230491
"2780",37747,0.4,1400000,140,230631
"2781",37773,0.5,2190000,219,230850
"2782",37677,0.5,4350000,435,231285
"2783",17910,0.5,7e+05,70,231355
"2784",37621,0.5,3690000,369,231724
"2785",37485,0.5,490000,49,231773
"2786",17754,0.5,490000,49,231822
"2789",17814,0.4,1270000,127,231949
"2790",17792,0.5,640000,64,232013
"2791",17832,0.5,1360000,136,232149
"2792",37499,0.5,1500000,150,232299
"2793",44079,0.5,8e+05,80,232379
"2794",44060,0.5,560000,56,232435
"2795",17800,0.5,720000,72,232507
"2796",37472,0.5,1700000,170,232677
"2797",18120,0.4,2180000,218,232895
"2798",44014,0.5,9e+05,90,232985
"2799",17803,0.4,2980000,298,233283
"2800",17601,0.5,640000,64,233347
"2801",17659,0.5,560000,56,233403
"2802",17837,0.3,2640000,264,233667
"2803",37463,0.5,2260000,226,233893
"2804",37267,0.5,560000,56,233949
"2805",37196,0.5,640000,64,234013
"2806",44023,0.5,2890000,289,234302
"2807",17549,0.4,1290000,129,234431
"2808",37256,0.5,7e+05,70,234501
"2809",17491,0.5,1e+06,100,234601
"2810",17488,0.5,7e+05,70,234671
"2811",37225,0.5,7e+05,70,234741
"2812",37243,0.5,560000,56,234797
"2813",17418,0.5,7e+05,70,234867
"2814",37202,0.5,490000,49,234916
"2815",17592,0.5,7e+05,70,234986
"2816",17700,0.357142857142857,6400000,640,235626
"2817",37117,0.5,7e+05,70,235696
"2818",17272,0.5,560000,56,235752
"2819",43982,0.5,560000,56,235808
"2820",17367,0.5,560000,56,235864
"2821",17489,0.5,1610000,161,236025
"2822",17306,0.4,1820000,182,236207
"2823",17319,0.4,1850000,185,236392
"2824",37197,0.5,2520000,252,236644
"2825",17330,0.5,7e+05,70,236714
"2826",37128,0.5,560000,56,236770
"2827",23365,0.5,630000,63,236833
"2828",17229,0.5,560000,56,236889
"2829",17171,0.5,560000,56,236945
"2830",17029,0.5,9e+05,90,237035
"2831",17015,0.5,8e+05,80,237115
"2832",23336,0.5,490000,49,237164
"2833",16900,0.5,560000,56,237220
"2834",36939,0.5,640000,64,237284
"2835",16944,0.5,560000,56,237340
"2836",17016,0.4,1840000,184,237524
"2837",37073,0.5,5100000,510,238034
"2838",16817,0.5,4400000,440,238474
"2839",16774,0.5,1290000,129,238603
"2840",37029,0.5,1440000,144,238747
"2841",16918,0.433333333333333,4e+06,400,239147
"2842",36895,0.4,1490000,149,239296
"2843",36916,0.5,3790000,379,239675
"2844",36911,0.5,7e+05,70,239745
"2845",16670,0.5,7e+05,70,239815
"2847",16818,0.5,1050000,105,239920
"2848",16730,0.5,560000,56,239976
"2849",36848,0.5,7e+05,70,240046
"2853",16349,0.5,7e+05,70,240116
"2855",44495,0.5,490000,49,240165
"2856",36917,0.5,8e+05,80,240245
"2857",16731,0.5,7e+05,70,240315
"2858",16289,0.5,7e+05,70,240385
"2859",16482,0.5,8e+05,80,240465
"2860",16056,0.5,1e+06,100,240565
"2861",44462,0.5,7e+05,70,240635
"2865",36869,0.5,7e+05,70,240705
"2866",37364,0.366666666666667,13550000,1355,242060
"2867",36788,0.5,2890000,289,242349
"2868",36757,0.5,7e+05,70,242419
"2869",16151,0.5,490000,49,242468
"2870",23139,0.5,1190000,119,242587
"2871",15914,0.5,1190000,119,242706
"2872",15878,0.5,490000,49,242755
"2873",15874,0.5,560000,56,242811
"2874",15987,0.5,560000,56,242867
"2875",16098,0.4,1430000,143,243010
"2876",36661,0.5,7e+05,70,243080
"2878",15651,0.5,7e+05,70,243150
"2879",44432,0.5,490000,49,243199
"2880",15807,0.5,560000,56,243255
"2881",44410,0.5,7e+05,70,243325
"2883",15826,0.5,9e+05,90,243415
"2884",16160,0.5,7e+05,70,243485
"2885",36564,0.5,8e+05,80,243565
"2886",36541,0.5,1e+06,100,243665
"2887",43859,0.5,7e+05,70,243735
"2889",15484,0.5,2150000,215,243950
"2890",36700,0.5,8e+05,80,244030
"2891",15579,0.5,1270000,127,244157
"2892",15868,0.4,1600000,160,244317
"2893",15647,0.5,640000,64,244381
"2894",36571,0.5,8e+05,80,244461
"2896",43873,0.5,2060000,206,244667
"2897",36489,0.5,720000,72,244739
"2898",36593,0.5,630000,63,244802
"2899",15725,0.5,5220000,522,245324
"2900",36508,0.5,1350000,135,245459
"2901",15556,0.5,2640000,264,245723
"2902",43834,0.5,810000,81,245804
"2903",43830,0.5,720000,72,245876
"2904",43846,0.5,9e+05,90,245966
"2905",44393,0.5,9e+05,90,246056
"2906",15382,0.5,630000,63,246119
"2907",36476,0.4,1260000,126,246245
"2908",36401,0.5,560000,56,246301
"2909",15508,0.3,1760000,176,246477
"2910",36413,0.5,8e+05,80,246557
"2911",15418,0.5,640000,64,246621
"2912",36514,0.366666666666667,2070000,207,246828
"2913",15324,0.5,640000,64,246892
"2914",43878,0.4,1930000,193,247085
"2915",43821,0.5,8e+05,80,247165
"2916",43828,0.433333333333333,4920000,492,247657
"2918",44379,0.5,640000,64,247721
"2919",36442,0.5,1690000,169,247890
"2920",15369,0.4,2200000,220,248110
"2921",15172,0.5,7e+05,70,248180
"2922",36360,0.5,1260000,126,248306
"2923",15111,0.5,7e+05,70,248376
"2924",36451,0.4,1890000,189,248565
"2925",36468,0.5,1050000,105,248670
"2926",36433,0.5,1050000,105,248775
"2927",15180,0.5,2310000,231,249006
"2928",36594,0.4,8580000,858,249864
"2929",15289,0.5,7e+05,70,249934
"2930",15566,0.333333333333333,9960000,996,250930
"2931",36386,0.5,1e+06,100,251030
"2932",15022,0.5,1e+06,100,251130
"2933",14987,0.5,8e+05,80,251210
"2935",36344,0.5,1800000,180,251390
"2936",14944,0.5,8e+05,80,251470
"2938",14985,0.3,980000,98,251568
"2939",15306,0.366666666666667,2190000,219,251787
"2940",36328,0.5,1850000,185,251972
"2941",15115,0.5,1360000,136,252108
"2942",14969,0.5,560000,56,252164
"2943",14964,0.4,2190000,219,252383
"2945",36395,0.4,2260000,226,252609
"2946",36221,0.5,1050000,105,252714
"2947",15358,0.35,3280000,328,253042
"2948",36318,0.5,490000,49,253091
"2949",14827,0.5,7e+05,70,253161
"2950",36263,0.5,1260000,126,253287
"2951",15124,0.4,1500000,150,253437
"2953",36293,0.5,1850000,185,253622
"2954",36179,0.5,1e+06,100,253722
"2955",14840,0.5,1360000,136,253858
"2956",36167,0.4,1400000,140,253998
"2957",36204,0.5,1190000,119,254117
"2958",14836,0.5,1190000,119,254236
"2959",14780,0.5,1e+06,100,254336
"2960",14918,0.5,8e+05,80,254416
"2961",15069,0.366666666666667,2260000,226,254642
"2962",36129,0.5,8e+05,80,254722
"2963",14627,0.433333333333333,2080000,208,254930
"2965",44361,0.5,7e+05,70,255000
"2966",36182,0.5,490000,49,255049
"2967",36172,0.5,490000,49,255098
"2968",14814,0.366666666666667,1990000,199,255297
"2969",14759,0.4,2050000,205,255502
"2970",36195,0.5,490000,49,255551
"2971",14792,0.5,1890000,189,255740
"2972",36173,0.5,1700000,170,255910
"2973",14734,0.5,560000,56,255966
"2974",36271,0.5,1050000,105,256071
"2975",14940,0.5,2500000,250,256321
"2976",15295,0.5,8070000,807,257128
"2977",36144,0.5,1050000,105,257233
"2978",14617,0.5,7e+05,70,257303
"2979",14605,0.4,1340000,134,257437
"2980",14651,0.4,1920000,192,257629
"2981",36155,0.5,4980000,498,258127
"2982",36107,0.4,4710000,471,258598
"2984",14886,0.4,5990000,599,259197
"2985",14772,0.5,560000,56,259253
"2986",36156,0.5,8e+05,80,259333
"2987",14692,0.5,1200000,120,259453
"2988",14580,0.5,640000,64,259517
"2989",14537,0.5,1440000,144,259661
"2990",36122,0.5,1050000,105,259766
"2991",14417,0.4,1600000,160,259926
"2992",14650,0.5,1850000,185,260111
"2994",14867,0.4,3420000,342,260453
"2995",14600,0.5,2720000,272,260725
"2996",36078,0.4,9070000,907,261632
"2997",14414,0.5,630000,63,261695
"2998",14781,0.5,2750000,275,261970
"2999",36065,0.5,1350000,135,262105
"3000",36132,0.433333333333333,5260000,526,262631
"3001",36034,0.5,630000,63,262694
"3002",14453,0.5,9e+05,90,262784
"3003",43690,0.5,9e+05,90,262874
"3004",44328,0.5,630000,63,262937
"3005",44337,0.5,1620000,162,263099
"3006",36020,0.5,8e+05,80,263179
"3007",36056,0.5,1190000,119,263298
"3008",14654,0.5,640000,64,263362
"3009",14291,0.5,720000,72,263434
"3010",14434,0.5,8e+05,80,263514
"3011",35931,0.5,8e+05,80,263594
"3012",14118,0.433333333333333,2990000,299,263893
"3013",14198,0.3,2450000,245,264138
"3014",35934,0.5,1200000,120,264258
"3015",14265,0.4,1690000,169,264427
"3016",43665,0.5,7e+05,70,264497
"3017",35871,0.5,1e+06,100,264597
"3018",14087,0.5,8e+05,80,264677
"3019",14557,0.3,3460000,346,265023
"3020",14185,0.5,7e+05,70,265093
"3021",35896,0.5,3300000,330,265423
"3022",35858,0.5,3110000,311,265734
"3023",14252,0.5,560000,56,265790
"3024",14234,0.4,1190000,119,265909
"3025",14090,0.5,1700000,170,266079
"3026",35901,0.5,2400000,240,266319
"3027",35772,0.4,1290000,129,266448
"3028",14103,0.5,1500000,150,266598
"3029",14037,0.5,8e+05,80,266678
"3030",35634,0.5,1360000,136,266814
"3031",13844,0.366666666666667,2360000,236,267050
"3032",13992,0.4,1950000,195,267245
"3033",43685,0.5,5600000,560,267805
"3034",14215,0.3,2120000,212,268017
"3035",43641,0.5,2160000,216,268233
"3036",35595,0.5,560000,56,268289
"3037",13958,0.5,1700000,170,268459
"3038",35682,0.5,1700000,170,268629
"3039",35559,0.5,560000,56,268685
"3040",13811,0.3,3490000,349,269034
"3041",13801,0.5,640000,64,269098
"3042",13929,0.3,1640000,164,269262
"3043",13887,0.4,1600000,160,269422
"3044",35706,0.3,3e+06,300,269722
"3046",35521,0.3,4e+06,400,270122
"3047",35437,0.5,7e+05,70,270192
"3048",13911,0.5,3190000,319,270511
"3049",13805,0.5,2700000,270,270781
"3050",35502,0.5,2060000,206,270987
"3051",13465,0.5,7e+05,70,271057
"3052",13645,0.5,7e+05,70,271127
"3053",13777,0.4,1690000,169,271296
"3054",35347,0.5,7e+05,70,271366
"3055",13522,0.5,1990000,199,271565
"3056",35189,0.5,1e+06,100,271665
"3057",13461,0.5,7e+05,70,271735
"3058",13399,0.5,9e+05,90,271825
"3059",13626,0.5,1e+06,100,271925
"3060",13293,0.5,1500000,150,272075
"3061",35108,0.5,1e+06,100,272175
"3062",13632,0.5,1e+06,100,272275
"3063",13074,0.5,8e+05,80,272355
"3064",13674,0.5,2400000,240,272595
"3065",13219,0.5,7e+05,70,272665
"3066",35194,0.5,1890000,189,272854
"3067",13169,0.5,630000,63,272917
"3070",34986,0.5,7e+05,70,272987
"3071",13457,0.5,560000,56,273043
"3072",35165,0.4,2760000,276,273319
"3073",13176,0.5,1260000,126,273445
"3074",13594,0.3,4010000,401,273846
"3075",35114,0.35,5490000,549,274395
"3076",34941,0.5,560000,56,274451
"3077",13122,0.3,2650000,265,274716
"3079",34835,0.5,1050000,105,274821
"3080",12904,0.5,490000,49,274870
"3081",12934,0.5,2240000,224,275094
"3082",34854,0.5,1190000,119,275213
"3083",12757,0.5,1800000,180,275393
"3084",34788,0.5,7e+05,70,275463
"3085",12717,0.5,1e+06,100,275563
"3086",12676,0.5,8e+05,80,275643
"3087",12739,0.5,7e+05,70,275713
"3088",12731,0.5,2960000,296,276009
"3089",23768,0.5,2960000,296,276305
"3090",12708,0.5,640000,64,276369
"3091",34730,0.5,8e+05,80,276449
"3092",12645,0.5,640000,64,276513
"3093",12657,0.5,1440000,144,276657
"3094",34806,0.5,2140000,214,276871
"3095",12721,0.4,1120000,112,276983
"3096",12352,0.4,2250000,225,277208
"3097",12572,0.5,8e+05,80,277288
"3098",34746,0.3,1920000,192,277480
"3099",34716,0.5,1620000,162,277642
"3100",12789,0.5,720000,72,277714
"3101",12406,0.5,630000,63,277777
"3102",34634,0.5,630000,63,277840
"3103",12447,0.4,1460000,146,277986
"3104",12423,0.5,810000,81,278067
"3105",34586,0.5,1620000,162,278229
"3106",12183,0.5,630000,63,278292
"3107",34691,0.5,8e+05,80,278372
"3108",12539,0.4,1920000,192,278564
"3109",12313,0.5,640000,64,278628
"3110",34541,0.5,1200000,120,278748
"3111",34520,0.4,1490000,149,278897
"3112",12873,0.5,3660000,366,279263
"3113",12504,0.5,1920000,192,279455
"3114",34720,0.4,1890000,189,279644
"3115",34355,0.5,560000,56,279700
"3116",12139,0.5,1050000,105,279805
"3117",43356,0.366666666666667,2120000,212,280017
"3118",34327,0.5,2200000,220,280237
"3119",12666,0.3,2200000,220,280457
"3120",34514,0.5,3690000,369,280826
"3121",12205,0.5,1700000,170,280996
"3122",34272,0.4,2060000,206,281202
"3123",11977,0.4,1850000,185,281387
"3124",34302,0.5,560000,56,281443
"3125",12047,0.5,490000,49,281492
"3126",35396,0.233333333333333,5160000,516,282008
"3127",11936,0.433333333333333,8220000,822,282830
"3128",11925,0.5,1290000,129,282959
"3129",11971,0.5,560000,56,283015
"3130",11962,0.5,1050000,105,283120
"3131",34518,0.5,2550000,255,283375
"3132",34154,0.5,1190000,119,283494
"3133",43341,0.5,3690000,369,283863
"3134",11896,0.5,560000,56,283919
"3135",34167,0.5,640000,64,283983
"3136",11819,0.5,560000,56,284039
"3137",11989,0.5,1440000,144,284183
"3138",34316,0.4,4230000,423,284606
"3139",34102,0.4,2800000,280,284886
"3140",11984,0.5,1700000,170,285056
"3141",34216,0.5,630000,63,285119
"3142",34071,0.5,720000,72,285191
"3143",34201,0.5,9e+05,90,285281
"3144",34251,0.22,7990000,799,286080
"3145",34079,0.4,1350000,135,286215
"3146",11733,0.5,9e+05,90,286305
"3147",34046,0.5,1990000,199,286504
"3148",11783,0.5,1990000,199,286703
"3149",34181,0.5,3050000,305,287008
"3151",34149,0.4,2160000,216,287224
"3152",21539,0.5,640000,64,287288
"3153",21556,0.5,1830000,183,287471
"3154",11757,0.4,1500000,150,287621
"3155",34058,0.4,1360000,136,287757
"3156",11732,0.5,2250000,225,287982
"3157",11663,0.5,1440000,144,288126
"3158",11878,0.25,3060000,306,288432
"3159",11794,0.3,1330000,133,288565
"3160",11637,0.5,1260000,126,288691
"3161",11603,0.5,8e+05,80,288771
"3162",11644,0.5,8e+05,80,288851
"3163",11824,0.4,1500000,150,289001
"3164",21515,0.5,1e+06,100,289101
"3165",43268,0.4,2200000,220,289321
"3166",33927,0.5,1e+06,100,289421
"3168",11527,0.5,7e+05,70,289491
"3169",33999,0.4,1960000,196,289687
"3170",21519,0.5,1190000,119,289806
"3171",11523,0.5,7e+05,70,289876
"3172",11682,0.4,2890000,289,290165
"3173",11445,0.5,630000,63,290228
"3174",43239,0.4,7e+06,700,290928
"3175",33752,0.5,490000,49,290977
"3176",11449,0.5,1700000,170,291147
"3177",11211,0.5,560000,56,291203
"3178",11303,0.5,560000,56,291259
"3179",33900,0.5,1890000,189,291448
"3180",11470,0.5,490000,49,291497
"3181",33921,0.4,1260000,126,291623
"3182",33803,0.5,560000,56,291679
"3183",21504,0.5,490000,49,291728
"3184",11274,0.5,560000,56,291784
"3185",11191,0.5,7e+05,70,291854
"3186",33641,0.5,560000,56,291910
"3187",33693,0.5,1190000,119,292029
"3188",11392,0.5,1990000,199,292228
"3189",11575,0.5,4300000,430,292658
"3190",33780,0.5,7e+05,70,292728
"3191",33685,0.5,2160000,216,292944
"3192",11293,0.5,1e+06,100,293044
"3193",33675,0.5,8e+05,80,293124
"3194",11273,0.5,1700000,170,293294
"3195",11242,0.5,2750000,275,293569
"3196",33661,0.5,8e+05,80,293649
"3197",43152,0.5,1190000,119,293768
"3198",43141,0.5,1800000,180,293948
"3199",11036,0.5,9e+05,90,294038
"3200",11204,0.5,1190000,119,294157
"3201",33686,0.5,1190000,119,294276
"3202",11217,0.5,1700000,170,294446
"3203",21499,0.5,1190000,119,294565
"3204",11339,0.5,490000,49,294614
"3205",21498,0.5,2500000,250,294864
"3206",11301,0.4,1680000,168,295032
"3207",21495,0.4,1490000,149,295181
"3208",33678,0.366666666666667,2900000,290,295471
"3209",11491,0.366666666666667,6e+06,600,296071
"3210",11152,0.4,1400000,140,296211
"3211",11143,0.3,2550000,255,296466
"3212",43119,0.5,2190000,219,296685
"3215",21474,0.5,7e+05,70,296755
"3216",11210,0.4,2300000,230,296985
"3217",33495,0.35,3430000,343,297328
"3218",11045,0.4,2400000,240,297568
"3219",10976,0.5,7e+05,70,297638
"3220",43103,0.5,7e+05,70,297708
"3221",43128,0.5,2550000,255,297963
"3222",10954,0.5,1990000,199,298162
"3225",33620,0.5,1360000,136,298298
"3226",21497,0.5,1800000,180,298478
"3227",33551,0.5,560000,56,298534
"3228",11048,0.5,1440000,144,298678
"3229",33566,0.5,1260000,126,298804
"3230",33417,0.5,8e+05,80,298884
"3231",11176,0.4,3690000,369,299253
"3232",21475,0.4,1360000,136,299389
"3233",11064,0.4,1190000,119,299508
"3234",10910,0.4,1260000,126,299634
"3235",10973,0.4,1700000,170,299804
"3236",33508,0.5,4330000,433,300237
"3237",10809,0.4,2750000,275,300512
"3238",21464,0.5,3810000,381,300893
"3239",33393,0.5,2190000,219,301112
"3240",33474,0.4,1500000,150,301262
"3241",10952,0.3,1950000,195,301457
"3242",10966,0.4,2e+06,200,301657
"3243",10797,0.5,7e+05,70,301727
"3244",33357,0.5,2690000,269,301996
"3245",33427,0.5,4450000,445,302441
"3246",10839,0.5,560000,56,302497
"3247",10752,0.4,1400000,140,302637
"3248",33305,0.5,490000,49,302686
"3249",10786,0.4,1750000,175,302861
"3250",33498,0.366666666666667,4110000,411,303272
"3251",33456,0.3,17930000,1793,305065
"3252",33219,0.5,1190000,119,305184
"3253",42975,0.5,1050000,105,305289
"3254",33324,0.5,2380000,238,305527
"3255",33315,0.5,7e+05,70,305597
"3256",10898,0.3,1990000,199,305796
"3257",21419,0.5,7e+05,70,305866
"3258",10695,0.5,1260000,126,305992
"3259",33151,0.5,560000,56,306048
"3260",10577,0.4,980000,98,306146
"3261",33220,0.4,1260000,126,306272
"3262",10625,0.5,7e+05,70,306342
"3264",10770,0.4,2400000,240,306582
"3265",10637,0.5,1360000,136,306718
"3266",10688,0.4,3640000,364,307082
"3267",33344,0.3,2500000,250,307332
"3268",10572,0.4,2160000,216,307548
"3269",44314,0.5,1e+06,100,307648
"3270",44315,0.4,1340000,134,307782
"3271",10589,0.433333333333333,2780000,278,308060
"3272",10488,0.5,640000,64,308124
"3273",33694,0.5,1200000,120,308244
"3274",10391,0.5,560000,56,308300
"3275",10460,0.5,1620000,162,308462
"3276",44319,0.5,2260000,226,308688
"3277",10486,0.5,640000,64,308752
"3278",33103,0.5,720000,72,308824
"3279",42943,0.5,630000,63,308887
"3280",10336,0.5,720000,72,308959
"3281",33144,0.5,2420000,242,309201
"3282",10376,0.5,1190000,119,309320
"3283",33010,0.5,640000,64,309384
"3284",33184,0.5,4180000,418,309802
"3285",10631,0.5,640000,64,309866
"3286",10287,0.5,8e+05,80,309946
"3287",10302,0.4,2340000,234,310180
"3288",10206,0.5,1340000,134,310314
"3289",44310,0.4,3970000,397,310711
"3290",33140,0.233333333333333,5530000,553,311264
"3291",32930,0.4,2050000,205,311469
"3292",33086,0.5,3180000,318,311787
"3293",33056,0.5,3280000,328,312115
"3294",10409,0.5,490000,49,312164
"3295",10214,0.3,1400000,140,312304
"3296",32891,0.4,1270000,127,312431
"3297",42926,0.5,8e+05,80,312511
"3298",32849,0.5,4310000,431,312942
"3299",32868,0.5,7e+05,70,313012
"3300",10203,0.5,1500000,150,313162
"3301",10190,0.5,1700000,170,313332
"3302",42906,0.4,1460000,146,313478
"3303",10160,0.5,7e+05,70,313548
"3304",32934,0.5,4880000,488,314036
"3305",32879,0.5,1190000,119,314155
"3306",32723,0.366666666666667,2540000,254,314409
"3307",32835,0.5,3690000,369,314778
"3308",32912,0.5,4560000,456,315234
"3309",10217,0.5,1750000,175,315409
"3310",32810,0.5,7e+05,70,315479
"3311",32738,0.5,1e+06,100,315579
"3312",32866,0.5,8400000,840,316419
"3313",9981,0.5,7e+05,70,316489
"3314",10046,0.5,8e+05,80,316569
"3315",9926,0.5,7e+05,70,316639
"3316",32768,0.4,2980000,298,316937
"3317",10080,0.3,1990000,199,317136
"3318",10147,0.5,1360000,136,317272
"3319",10127,0.5,1290000,129,317401
"3320",21379,0.4,1260000,126,317527
"3321",32800,0.5,3620000,362,317889
"3322",10040,0.366666666666667,2160000,216,318105
"3323",32888,0.5,2550000,255,318360
"3324",32897,0.34,3210000,321,318681
"3325",32664,0.5,7e+05,70,318751
"3326",10199,0.5,1360000,136,318887
"3327",32682,0.5,560000,56,318943
"3328",10000,0.5,1050000,105,319048
"3329",10076,0.4,3620000,362,319410
"3330",9954,0.34,8600000,860,320270
"3331",10095,0.5,1050000,105,320375
"3332",32736,0.35,3140000,314,320689
"3333",32512,0.5,560000,56,320745
"3334",32498,0.5,640000,64,320809
"3336",32945,0.3,10770000,1077,321886
"3337",9963,0.5,1700000,170,322056
"3338",9757,0.5,7e+05,70,322126
"3339",32577,0.5,1e+06,100,322226
"3340",10125,0.5,8e+05,80,322306
"3341",9790,0.5,8e+05,80,322386
"3342",32646,0.5,7e+05,70,322456
"3343",9877,0.4,1600000,160,322616
"3344",32689,0.4,1820000,182,322798
"3345",32384,0.5,8e+05,80,322878
"3346",32456,0.4,2690000,269,323147
"3347",32799,0.3,5450000,545,323692
"3348",10192,0.2,3380000,338,324030
"3349",42871,0.3,7160000,716,324746
"3351",32546,0.5,1190000,119,324865
"3352",32440,0.5,490000,49,324914
"3353",32627,0.5,1700000,170,325084
"3354",32338,0.5,7e+05,70,325154
"3355",9695,0.4,2260000,226,325380
"3357",9547,0.4,2e+06,200,325580
"3358",9277,0.4,1400000,140,325720
"3359",9278,0.5,1e+06,100,325820
"3360",9488,0.4,4980000,498,326318
"3361",32687,0.5,13810000,1381,327699
"3362",21336,0.5,980000,98,327797
"3363",9641,0.4,1490000,149,327946
"3364",42717,0.5,490000,49,327995
"3365",32033,0.5,1050000,105,328100
"3366",9035,0.5,560000,56,328156
"3367",32049,0.5,7e+05,70,328226
"3368",9043,0.4,2290000,229,328455
"3369",9168,0.5,8e+05,80,328535
"3370",42851,0.4,10420000,1042,329577
"3371",31967,0.5,7e+05,70,329647
"3372",42684,0.5,8e+05,80,329727
"3373",9010,0.3,1490000,149,329876
"3374",31964,0.5,560000,56,329932
"3376",21349,0.5,2260000,226,330158
"3377",8992,0.4,1360000,136,330294
"3378",9216,0.4,1120000,112,330406
"3379",31759,0.5,8e+05,80,330486
"3380",31713,0.5,490000,49,330535
"3381",31756,0.3,8300000,830,331365
"3382",32058,0.2,4570000,457,331822
"3383",8819,0.5,1750000,175,331997
"3384",8862,0.433333333333333,2760000,276,332273
"3385",8920,0.5,1e+06,100,332373
"3386",8874,0.433333333333333,2530000,253,332626
"3387",31897,0.5,5590000,559,333185
"3388",31644,0.5,7e+05,70,333255
"3389",8695,0.5,1e+06,100,333355
"3390",8774,0.4,1400000,140,333495
"3391",23732,0.4,1260000,126,333621
"3392",8514,0.5,490000,49,333670
"3393",23722,0.4,1490000,149,333819
"3394",8663,0.5,1e+06,100,333919
"3396",21293,0.5,2260000,226,334145
"3397",8759,0.4,1560000,156,334301
"3398",31330,0.5,2500000,250,334551
"3399",23707,0.5,490000,49,334600
"3400",8688,0.5,7e+05,70,334670
"3402",31734,0.4,2660000,266,334936
"3403",42526,0.5,7e+05,70,335006
"3404",8224,0.5,490000,49,335055
"3405",21380,0.366666666666667,1780000,178,335233
"3406",31763,0.5,4970000,497,335730
"3407",42625,0.5,3990000,399,336129
"3408",42718,0.3,5090000,509,336638
"3409",8527,0.4,1260000,126,336764
"3410",8482,0.5,630000,63,336827
"3411",42445,0.5,1350000,135,336962
"3412",8325,0.5,630000,63,337025
"3413",30980,0.5,630000,63,337088
"3414",23686,0.5,2090000,209,337297
"3415",42410,0.5,560000,56,337353
"3416",8191,0.5,2260000,226,337579
"3417",8212,0.4,4880000,488,338067
"3418",31010,0.5,9e+05,90,338157
"3420",42538,0.5,10900000,1090,339247
"3421",30972,0.5,1990000,199,339446
"3422",8071,0.4,1520000,152,339598
"3423",8058,0.5,1200000,120,339718
"3424",8060,0.5,1260000,126,339844
"3425",30791,0.5,1990000,199,340043
"3426",42464,0.3,4890000,489,340532
"3427",42376,0.35,2930000,293,340825
"3428",30829,0.5,490000,49,340874
"3429",21207,0.5,490000,49,340923
"3430",8371,0.433333333333333,1820000,182,341105
"3431",21215,0.5,3550000,355,341460
"3432",30457,0.4,6490000,649,342109
"3433",7508,0.5,1190000,119,342228
"3434",30167,0.5,490000,49,342277
"3435",30563,0.5,5680000,568,342845
"3436",30461,0.5,5600000,560,343405
"3437",30080,0.4,1260000,126,343531
"3438",7364,0.5,1260000,126,343657
"3439",30056,0.5,490000,49,343706
"3440",7197,0.5,7e+05,70,343776
"3441",7095,0.5,7e+05,70,343846
"3443",30364,0.366666666666667,1960000,196,344042
"3444",42298,0.366666666666667,2160000,216,344258
"3445",42314,0.5,3250000,325,344583
"3446",21183,0.5,1e+06,100,344683
"3447",29816,0.5,7e+05,70,344753
"3448",7161,0.5,8e+05,80,344833
"3449",8030,0.366666666666667,3520000,352,345185
"3450",29811,0.5,7e+05,70,345255
"3451",21172,0.5,2760000,276,345531
"3452",30382,0.5,4740000,474,346005
"3453",30093,0.5,2500000,250,346255
"3454",7145,0.4,1890000,189,346444
"3455",6914,0.5,490000,49,346493
"3456",6791,0.4,1260000,126,346619
"3457",7314,0.366666666666667,3300000,330,346949
"3459",42236,0.5,1990000,199,347148
"3460",42226,0.5,1050000,105,347253
"3461",7146,0.5,640000,64,347317
"3462",7351,0.4,1340000,134,347451
"3463",6891,0.366666666666667,1830000,183,347634
"3464",29435,0.5,8e+05,80,347714
"3465",29883,0.3,5190000,519,348233
"3466",29604,0.5,2e+06,200,348433
"3467",29957,0.5,1e+06,100,348533
"3468",21161,0.5,1260000,126,348659
"3469",30198,0.5,4990000,499,349158
"3470",6836,0.5,1e+06,100,349258
"3471",21139,0.5,2140000,214,349472
"3472",29462,0.5,1e+06,100,349572
"3473",29769,0.5,1700000,170,349742
"3474",42179,0.5,1e+06,100,349842
"3475",6677,0.5,1750000,175,350017
"3476",42199,0.5,3060000,306,350323
"3477",21169,0.4,3680000,368,350691
"3478",21129,0.5,1700000,170,350861
"3479",29709,0.5,7e+05,70,350931
"3480",42170,0.5,490000,49,350980
"3481",6372,0.5,490000,49,351029
"3482",29438,0.3,1890000,189,351218
"3483",21113,0.5,980000,98,351316
"3484",29152,0.4,1050000,105,351421
"3485",29508,0.5,2240000,224,351645
"3486",29189,0.5,1260000,126,351771
"3487",42148,0.5,1120000,112,351883
"3488",6223,0.5,1120000,112,351995
"3489",29150,0.5,1e+06,100,352095
"3490",6221,0.4,2e+06,200,352295
"3491",21114,0.5,3810000,381,352676
"3492",29375,0.5,1e+06,100,352776
"3493",29937,0.5,25610000,2561,355337
"3494",29017,0.4,4390000,439,355776
"3495",6340,0.4,1500000,150,355926
"3496",29110,0.5,3450000,345,356271
"3497",6811,0.3,5800000,580,356851
"3498",42064,0.5,7e+05,70,356921
"3499",6356,0.4,1190000,119,357040
"3500",6064,0.5,1e+06,100,357140
"3501",6025,0.5,8e+05,80,357220
"3502",28985,0.5,7e+05,70,357290
"3503",6136,0.4,1190000,119,357409
"3505",42096,0.5,1260000,126,357535
"3507",6044,0.5,7e+05,70,357605
"3508",6000,0.5,560000,56,357661
"3509",28882,0.5,7e+05,70,357731
"3510",28919,0.5,7e+05,70,357801
"3512",28968,0.5,4950000,495,358296
"3513",28900,0.5,2500000,250,358546
"3514",42032,0.5,8e+05,80,358626
"3515",28893,0.5,2750000,275,358901
"3516",6067,0.5,7e+05,70,358971
"3517",28888,0.5,1190000,119,359090
"3519",42083,0.4,5090000,509,359599
"3520",41955,0.4,9200000,920,360519
"3521",5782,0.5,8e+05,80,360599
"3522",28839,0.5,640000,64,360663
"3523",6024,0.5,8e+05,80,360743
"3524",42037,0.4,1260000,126,360869
"3525",42088,0.5,4410000,441,361310
"3526",42021,0.5,640000,64,361374
"3527",42034,0.5,8e+05,80,361454
"3528",28992,0.5,3750000,375,361829
"3529",6120,0.4,1820000,182,362011
"3530",28800,0.5,8e+05,80,362091
"3532",5774,0.366666666666667,1820000,182,362273
"3533",28723,0.3,11950000,1195,363468
"3534",41766,0.5,560000,56,363524
"3536",28827,0.5,1610000,161,363685
"3537",28791,0.366666666666667,1620000,162,363847
"3538",28810,0.5,1760000,176,364023
"3539",28771,0.5,2700000,270,364293
"3540",5910,0.5,1050000,105,364398
"3541",28790,0.5,7e+05,70,364468
"3542",41895,0.5,560000,56,364524
"3543",5862,0.5,490000,49,364573
"3544",5741,0.5,1120000,112,364685
"3545",41784,0.5,490000,49,364734
"3546",5946,0.5,490000,49,364783
"3547",5649,0.5,490000,49,364832
"3548",5899,0.5,1e+06,100,364932
"3549",28591,0.5,1e+06,100,365032
"3550",41950,0.5,3550000,355,365387
"3551",5597,0.5,1e+06,100,365487
"3552",5778,0.5,1e+06,100,365587
"3553",41859,0.5,8e+05,80,365667
"3554",28412,0.5,1e+06,100,365767
"3555",5841,0.5,7e+05,70,365837
"3556",41724,0.5,1500000,150,365987
"3557",41709,0.5,7e+05,70,366057
"3558",6,0.35,2620000,262,366319
"3559",28492,0.5,1260000,126,366445
"3560",42068,0.5,4750000,475,366920
"3561",41732,0.5,2240000,224,367144
"3562",28799,0.5,6780000,678,367822
"3563",5949,0.4,1360000,136,367958
"3564",28358,0.5,490000,49,368007
"3565",28333,0.5,490000,49,368056
"3566",5549,0.4,1850000,185,368241
"3567",5352,0.4,1490000,149,368390
"3568",41581,0.5,1e+06,100,368490
"3569",41579,0.5,8e+05,80,368570
"3570",41648,0.5,1e+06,100,368670
"3571",5516,0.5,8e+05,80,368750
"3572",28307,0.5,2400000,240,368990
"3573",5456,0.5,8e+05,80,369070
"3574",28272,0.5,8e+05,80,369150
"3575",28241,0.5,7e+05,70,369220
"3576",5557,0.4,4080000,408,369628
"3578",41427,0.5,7e+05,70,369698
"3579",5259,0.5,8e+05,80,369778
"3580",42063,0.5,7250000,725,370503
"3581",28222,0.5,1750000,175,370678
"3582",5376,0.5,560000,56,370734
"3583",41773,0.3,5760000,576,371310
"3584",20967,0.5,640000,64,371374
"3585",41600,0.5,560000,56,371430
"3586",28126,0.5,560000,56,371486
"3587",28223,0.5,1690000,169,371655
"3588",5240,0.5,560000,56,371711
"3589",5780,0.25,4220000,422,372133
"3590",28421,0.4,3270000,327,372460
"3591",42038,0.4,3340000,334,372794
"3592",6029,0.3,2800000,280,373074
"3593",41383,0.5,2090000,209,373283
"3594",41408,0.5,1360000,136,373419
"3595",5063,0.5,1920000,192,373611
"3596",20929,0.5,8e+05,80,373691
"3597",20943,0.5,560000,56,373747
"3598",20903,0.5,640000,64,373811
"3599",41207,0.5,2140000,214,374025
"3600",27650,0.5,560000,56,374081
"3601",41139,0.5,9e+05,90,374171
"3602",41149,0.5,8e+05,80,374251
"3603",27915,0.4,3160000,316,374567
"3604",27568,0.5,7e+05,70,374637
"3605",41056,0.5,8e+05,80,374717
"3606",4705,0.5,8e+05,80,374797
"3609",5879,0.271428571428571,6540000,654,375451
"3610",4902,0.4,1290000,129,375580
"3611",41459,0.5,5640000,564,376144
"3612",41188,0.5,1190000,119,376263
"3615",27518,0.5,560000,56,376319
"3616",27416,0.5,630000,63,376382
"3617",41037,0.5,560000,56,376438
"3618",4529,0.5,490000,49,376487
"3619",20656,0.5,7e+05,70,376557
"3620",4555,0.5,490000,49,376606
"3621",40976,0.5,8e+05,80,376686
"3622",27299,0.5,7e+05,70,376756
"3623",27384,0.5,7e+05,70,376826
"3624",4375,0.5,1e+06,100,376926
"3626",40952,0.4,3060000,306,377232
"3628",27142,0.5,490000,49,377281
"3629",27110,0.5,560000,56,377337
"3631",27608,0.5,1360000,136,377473
"3632",4238,0.5,8e+05,80,377553
"3634",3966,0.5,560000,56,377609
"3635",40801,0.5,7e+05,70,377679
"3636",40841,0.5,1e+06,100,377779
"3637",27005,0.4,3060000,306,378085
"3638",3979,0.5,1e+06,100,378185
"3641",4333,0.5,7e+05,70,378255
"3642",40869,0.5,3750000,375,378630
"3643",3864,0.5,490000,49,378679
"3644",40777,0.5,560000,56,378735
"3645",3901,0.5,7e+05,70,378805
"3646",26896,0.5,7e+05,70,378875
"3647",3871,0.5,560000,56,378931
"3648",26903,0.5,490000,49,378980
"3649",3867,0.5,1700000,170,379150
"3650",26805,0.5,1e+06,100,379250
"3651",26867,0.5,1700000,170,379420
"3652",26919,0.5,1800000,180,379600
"3653",26736,0.5,8e+05,80,379680
"3654",3769,0.5,1190000,119,379799
"3655",3708,0.5,7e+05,70,379869
"3656",20095,0.5,560000,56,379925
"3657",3591,0.5,490000,49,379974
"3658",3646,0.5,490000,49,380023
"3659",26758,0.5,560000,56,380079
"3660",26707,0.5,630000,63,380142
"3661",26816,0.5,1190000,119,380261
"3662",40695,0.5,490000,49,380310
"3664",26634,0.5,560000,56,380366
"3665",26661,0.5,7e+05,70,380436
"3666",4016,0.4,1190000,119,380555
"3667",26788,0.5,980000,98,380653
"3668",26709,0.5,1400000,140,380793
"3669",40676,0.5,1190000,119,380912
"3670",3468,0.4,1190000,119,381031
"3671",3409,0.5,7e+05,70,381101
"3672",26625,0.5,490000,49,381150
"3673",20345,0.5,1e+06,100,381250
"3674",26724,0.5,1360000,136,381386
"3675",26578,0.5,7e+05,70,381456
"3676",3410,0.5,7e+05,70,381526
"3677",3425,0.5,1e+06,100,381626
"3678",26513,0.5,7e+05,70,381696
"3679",20005,0.5,7e+05,70,381766
"3680",19962,0.5,1260000,126,381892
"3681",3342,0.5,8e+05,80,381972
"3682",3185,0.5,560000,56,382028
"3683",26555,0.4,2870000,287,382315
"3684",40638,0.5,640000,64,382379
"3685",40643,0.5,560000,56,382435
"3686",3201,0.5,8e+05,80,382515
"3687",3168,0.5,640000,64,382579
"3688",26466,0.5,640000,64,382643
"3689",26631,0.5,3840000,384,383027
"3692",19760,0.5,560000,56,383083
"3693",40616,0.5,720000,72,383155
"3694",22951,0.5,8510000,851,384006
"3695",26422,0.5,720000,72,384078
"3696",3435,0.5,1620000,162,384240
"3697",26414,0.5,720000,72,384312
"3698",26528,0.5,2430000,243,384555
"3700",26413,0.4,1130000,113,384668
"3701",22853,0.5,560000,56,384724
"3702",22892,0.5,1360000,136,384860
"3703",2904,0.5,640000,64,384924
"3704",26400,0.5,640000,64,384988
"3705",19680,0.5,560000,56,385044
"3706",2982,0.5,8e+05,80,385124
"3707",26410,0.5,2480000,248,385372
"3708",2947,0.5,1190000,119,385491
"3709",26354,0.5,490000,49,385540
"3710",26421,0.4,1990000,199,385739
"3711",26363,0.5,560000,56,385795
"3712",22792,0.5,7e+05,70,385865
"3713",2828,0.5,7e+05,70,385935
"3714",2786,0.5,7e+05,70,386005
"3715",26323,0.5,8e+05,80,386085
"3716",26361,0.5,3060000,306,386391
"3717",3517,0.366666666666667,1610000,161,386552
"3718",22741,0.5,490000,49,386601
"3719",26301,0.5,560000,56,386657
"3723",2728,0.5,560000,56,386713
"3724",22664,0.5,8e+05,80,386793
"3726",19511,0.5,2180000,218,387011
"3727",2649,0.233333333333333,4410000,441,387452
"3728",2679,0.4,1460000,146,387598
"3729",2598,0.5,1530000,153,387751
"3730",26243,0.5,1360000,136,387887
"3732",40461,0.4,4040000,404,388291
"3733",26242,0.4,3800000,380,388671
"3734",2392,0.5,640000,64,388735
"3735",2354,0.5,8e+05,80,388815
"3736",40368,0.5,560000,56,388871
"3737",2414,0.5,640000,64,388935
"3738",26232,0.3,3690000,369,389304
"3739",40352,0.5,1e+06,100,389404
"3740",40359,0.5,1440000,144,389548
"3742",2314,0.5,1700000,170,389718
"3743",19385,0.4,1490000,149,389867
"3744",40303,0.5,560000,56,389923
"3745",40315,0.5,1050000,105,390028
"3746",2223,0.5,7e+05,70,390098
"3747",40244,0.5,560000,56,390154
"3748",40274,0.5,490000,49,390203
"3749",40281,0.5,560000,56,390259
"3750",26147,0.5,7e+05,70,390329
"3751",1985,0.5,7e+05,70,390399
"3752",44208,0.4,2450000,245,390644
"3753",2000,0.5,1260000,126,390770
"3754",40137,0.4,3210000,321,391091
"3755",40115,0.4,2730000,273,391364
"3756",40102,0.5,8e+05,80,391444
"3757",1861,0.5,1e+06,100,391544
"3758",1930,0.5,720000,72,391616
"3759",22424,0.5,7e+05,70,391686
"3760",40058,0.5,560000,56,391742
"3761",40053,0.5,1050000,105,391847
"3762",40060,0.5,490000,49,391896
"3763",18994,0.5,7e+05,70,391966
"3764",25972,0.5,7e+05,70,392036
"3765",1819,0.3,2190000,219,392255
"3766",40009,0.4,1560000,156,392411
"3768",40047,0.5,2260000,226,392637
"3769",40019,0.5,7e+05,70,392707
"3770",1840,0.5,7e+05,70,392777
"3771",25855,0.5,1e+06,100,392877
"3772",25922,0.5,1360000,136,393013
"3773",25893,0.5,7e+05,70,393083
"3775",1668,0.5,7e+05,70,393153
"3776",25950,0.5,2680000,268,393421
"3777",25808,0.5,1700000,170,393591
"3778",25844,0.5,1190000,119,393710
"3779",25680,0.5,9e+05,90,393800
"3780",25788,0.5,8e+05,80,393880
"3781",1659,0.5,1360000,136,394016
"3782",25631,0.5,630000,63,394079
"3783",25888,0.5,7e+05,70,394149
"3784",39996,0.5,2190000,219,394368
"3785",25573,0.5,560000,56,394424
"3786",25552,0.5,560000,56,394480
"3787",1474,0.5,560000,56,394536
"3788",25399,0.5,560000,56,394592
"3789",25421,0.5,1270000,127,394719
"3790",39975,0.5,2550000,255,394974
"3791",1402,0.5,1280000,128,395102
"3792",1465,0.5,1350000,135,395237
"3793",1512,0.45,4820000,482,395719
"3797",25368,0.5,1620000,162,395881
"3798",1356,0.5,720000,72,395953
"3799",25308,0.5,720000,72,396025
"3800",1358,0.5,630000,63,396088
"3801",23544,0.5,560000,56,396144
"3802",25154,0.5,640000,64,396208
"3803",25139,0.5,8e+05,80,396288
"3804",39944,0.5,5620000,562,396850
"3805",1259,0.5,8e+05,80,396930
"3806",25111,0.5,560000,56,396986
"3807",25100,0.5,1050000,105,397091
"3808",25143,0.5,560000,56,397147
"3809",39725,0.5,560000,56,397203
"3810",1430,0.5,560000,56,397259
"3811",39837,0.5,4750000,475,397734
"3812",39832,0.5,6e+06,600,398334
"3813",24956,0.5,7e+05,70,398404
"3814",25020,0.5,8e+05,80,398484
"3816",1141,0.5,1e+06,100,398584
"3817",1134,0.5,8e+05,80,398664
"3818",39734,0.5,2400000,240,398904
"3819",1097,0.5,1e+06,100,399004
"3820",39648,0.5,490000,49,399053
"3821",39666,0.5,7e+05,70,399123
"3822",24980,0.5,1190000,119,399242
"3823",25609,0.5,11740000,1174,400416
"3824",39651,0.5,7e+05,70,400486
"3825",39645,0.5,1e+06,100,400586
"3826",997,0.5,8e+05,80,400666
"3827",25334,0.5,1e+06,100,400766
"3828",25319,0.5,2550000,255,401021
"3829",24446,0.5,7e+05,70,401091
"3830",926,0.4,1280000,128,401219
"3831",24732,0.5,3190000,319,401538
"3832",39419,0.5,630000,63,401601
"3833",770,0.5,9e+05,90,401691
"3834",39377,0.5,720000,72,401763
"3835",39501,0.5,1530000,153,401916
"3836",756,0.5,1350000,135,402051
"3837",1370,0.3,3390000,339,402390
"3838",39237,0.5,8e+05,80,402470
"3839",24359,0.5,2260000,226,402696
"3840",740,0.5,8e+05,80,402776
"3841",39266,0.5,720000,72,402848
"3842",39210,0.5,1800000,180,403028
"3843",39232,0.5,1900000,190,403218
"3844",39131,0.5,1e+06,100,403318
"3845",39114,0.5,7e+05,70,403388
"3846",24267,0.5,8e+05,80,403468
"3847",39079,0.5,9e+05,90,403558
"3848",812,0.5,560000,56,403614
"3849",24315,0.4,2140000,214,403828
"3850",39263,0.5,3750000,375,404203
"3851",634,0.5,2800000,280,404483
"3852",24210,0.4,1500000,150,404633
"3853",24136,0.5,560000,56,404689
"3854",437,0.5,490000,49,404738
"3855",524,0.5,1750000,175,404913
"3856",593,0.4,1400000,140,405053
"3857",39002,0.5,8440000,844,405897
"3858",38352,0.3,1500000,150,406047
"3859",18975,0.3,7e+05,70,406117
"3860",18983,0.3,1360000,136,406253
"3861",18963,0.3,1190000,119,406372
"3862",18880,0.3,8e+05,80,406452
"3863",18936,0.3,7e+05,70,406522
"3864",38313,0.3,1e+06,100,406622
"3865",38326,0.3,3250000,325,406947
"3867",38229,0.3,7e+05,70,407017
"3868",18711,0.3,1190000,119,407136
"3869",18700,0.3,490000,49,407185
"3870",18914,0.3,2550000,255,407440
"3871",18765,0.166666666666667,1850000,185,407625
"3872",18851,0.3,560000,56,407681
"3873",18654,0.3,560000,56,407737
"3875",38197,0.3,560000,56,407793
"3876",18616,0.3,560000,56,407849
"3877",18648,0.3,560000,56,407905
"3878",38276,0.3,3950000,395,408300
"3879",38172,0.3,560000,56,408356
"3880",18653,0.3,490000,49,408405
"3881",38183,0.3,8e+05,80,408485
"3882",38160,0.3,9e+05,90,408575
"3883",38259,0.2,1400000,140,408715
"3884",38144,0.3,9e+05,90,408805
"3885",38121,0.3,8e+05,80,408885
"3886",18704,0.3,3690000,369,409254
"3887",38089,0.3,7e+05,70,409324
"3888",38054,0.3,7e+05,70,409394
"3889",5,0.3,560000,56,409450
"3890",18630,0.3,1360000,136,409586
"3891",38099,0.3,640000,64,409650
"3892",18540,0.2,1120000,112,409762
"3893",18780,0.166666666666667,3790000,379,410141
"3894",38131,0.3,2800000,280,410421
"3895",38153,0.2,1500000,150,410571
"3896",18620,0.2,2260000,226,410797
"3897",18571,0.3,640000,64,410861
"3898",18378,0.3,1120000,112,410973
"3899",38212,0.3,8e+05,80,411053
"3900",38174,0.3,2500000,250,411303
"3901",38059,0.3,2060000,206,411509
"3902",37938,0.3,640000,64,411573
"3903",37946,0.3,560000,56,411629
"3904",18352,0.3,1050000,105,411734
"3905",37960,0.3,7e+05,70,411804
"3906",18516,0.3,490000,49,411853
"3907",37915,0.3,7e+05,70,411923
"3908",38067,0.3,1750000,175,412098
"3909",18301,0.3,490000,49,412147
"3910",38116,0.3,4260000,426,412573
"3911",38102,0.3,2e+06,200,412773
"3912",18227,0.3,1e+06,100,412873
"3913",18261,0.3,8e+05,80,412953
"3914",18394,0.3,1360000,136,413089
"3915",37998,0.3,1700000,170,413259
"3916",38019,0.3,1700000,170,413429
"3917",18217,0.3,1400000,140,413569
"3918",37852,0.3,7e+05,70,413639
"3919",18307,0.3,8e+05,80,413719
"3920",18295,0.3,1190000,119,413838
"3921",38075,0.3,3090000,309,414147
"3922",37867,0.3,1050000,105,414252
"3923",18220,0.3,1190000,119,414371
"3924",18163,0.2,1400000,140,414511
"3925",37914,0.3,490000,49,414560
"3926",18422,0.166666666666667,6930000,693,415253
"3927",37844,0.3,1560000,156,415409
"3928",37805,0.3,490000,49,415458
"3929",37920,0.2,4060000,406,415864
"3930",18389,0.166666666666667,1820000,182,416046
"3931",37721,0.3,7e+05,70,416116
"3932",37681,0.3,8e+05,80,416196
"3933",18132,0.3,1190000,119,416315
"3934",18297,0.3,6260000,626,416941
"3935",37829,0.3,7e+05,70,417011
"3936",18200,0.3,8e+05,80,417091
"3937",37680,0.3,560000,56,417147
"3938",17971,0.3,490000,49,417196
"3939",18144,0.3,3200000,320,417516
"3940",18038,0.3,1050000,105,417621
"3941",37688,0.3,1260000,126,417747
"3942",37732,0.2,1290000,129,417876
"3943",18017,0.2,1260000,126,418002
"3944",18012,0.3,1190000,119,418121
"3945",18041,0.3,560000,56,418177
"3946",37666,0.3,1190000,119,418296
"3947",37754,0.3,3200000,320,418616
"3948",17841,0.3,1430000,143,418759
"3949",37462,0.3,640000,64,418823
"3950",17878,0.3,560000,56,418879
"3951",37577,0.3,8e+05,80,418959
"3952",17895,0.3,560000,56,419015
"3953",37517,0.3,560000,56,419071
"3954",37556,0.3,640000,64,419135
"3955",17921,0.3,1430000,143,419278
"3956",17853,0.3,560000,56,419334
"3957",18066,0.3,2950000,295,419629
"3958",17881,0.3,8e+05,80,419709
"3959",18044,0.3,1440000,144,419853
"3960",37401,0.3,560000,56,419909
"3961",37632,0.3,8e+05,80,419989
"3962",18086,0.3,3550000,355,420344
"3963",17997,0.2,1340000,134,420478
"3964",37503,0.3,1830000,183,420661
"3965",37433,0.3,9e+05,90,420751
"3966",17778,0.3,2520000,252,421003
"3967",37471,0.3,720000,72,421075
"3968",17849,0.3,630000,63,421138
"3969",17745,0.3,2320000,232,421370
"3970",37571,0.3,9e+05,90,421460
"3971",37449,0.3,720000,72,421532
"3972",37356,0.3,9e+05,90,421622
"3973",17703,0.3,630000,63,421685
"3974",37400,0.3,1990000,199,421884
"3975",17869,0.3,720000,72,421956
"3976",37689,0.3,3450000,345,422301
"3977",17794,0.3,630000,63,422364
"3978",37474,0.3,2090000,209,422573
"3979",37396,0.2,1720000,172,422745
"3980",17716,0.3,1350000,135,422880
"3981",17835,0.3,2160000,216,423096
"3982",37501,0.3,3280000,328,423424
"3983",17781,0.3,1360000,136,423560
"3984",17651,0.3,1200000,120,423680
"3985",17610,0.3,8e+05,80,423760
"3986",37304,0.3,560000,56,423816
"3987",17635,0.3,560000,56,423872
"3988",17658,0.3,640000,64,423936
"3989",37392,0.3,560000,56,423992
"3990",37332,0.3,640000,64,424056
"3991",17638,0.3,560000,56,424112
"3992",17753,0.3,2260000,226,424338
"3993",17676,0.3,640000,64,424402
"3994",17750,0.3,1990000,199,424601
"3995",44040,0.3,8e+05,80,424681
"3996",17773,0.3,4040000,404,425085
"3997",17599,0.3,7e+05,70,425155
"3998",17709,0.3,1440000,144,425299
"3999",17729,0.3,7e+05,70,425369
"4000",17628,0.3,3140000,314,425683
"4001",17580,0.3,1500000,150,425833
"4002",17686,0.3,1800000,180,426013
"4003",37325,0.3,1620000,162,426175
"4004",37330,0.3,1440000,144,426319
"4005",37272,0.3,2500000,250,426569
"4006",17413,0.3,8e+05,80,426649
"4007",17449,0.3,560000,56,426705
"4008",17468,0.3,560000,56,426761
"4009",37163,0.3,490000,49,426810
"4010",17365,0.3,560000,56,426866
"4011",17357,0.3,7e+05,70,426936
"4012",17524,0.3,1990000,199,427135
"4013",17486,0.3,2060000,206,427341
"4014",17403,0.3,1990000,199,427540
"4015",17546,0.3,490000,49,427589
"4016",37158,0.3,560000,56,427645
"4017",17688,0.2,2060000,206,427851
"4018",17452,0.3,490000,49,427900
"4019",17428,0.3,980000,98,427998
"4020",37171,0.3,7e+05,70,428068
"4021",17314,0.3,490000,49,428117
"4022",17462,0.3,1890000,189,428306
"4023",37206,0.3,490000,49,428355
"4024",37103,0.3,560000,56,428411
"4025",17292,0.214285714285714,12080000,1208,429619
"4026",37067,0.3,7e+05,70,429689
"4028",17526,0.3,4250000,425,430114
"4029",17256,0.3,1e+06,100,430214
"4030",37078,0.3,8e+05,80,430294
"4031",17302,0.3,5810000,581,430875
"4032",37096,0.3,3810000,381,431256
"4033",37125,0.3,2400000,240,431496
"4034",17184,0.3,1e+06,100,431596
"4035",37101,0.3,7e+05,70,431666
"4036",17470,0.3,1e+06,100,431766
"4037",37063,0.3,7e+05,70,431836
"4038",17185,0.3,9e+05,90,431926
"4039",17341,0.3,2620000,262,432188
"4040",17246,0.3,1e+06,100,432288
"4041",36994,0.3,7e+05,70,432358
"4042",17089,0.3,8e+05,80,432438
"4043",23354,0.3,1700000,170,432608
"4044",17005,0.3,7e+05,70,432678
"4045",37074,0.3,1190000,119,432797
"4046",17260,0.3,7e+05,70,432867
"4047",17269,0.3,560000,56,432923
"4048",17349,0.3,1190000,119,433042
"4049",17051,0.3,7e+05,70,433112
"4050",37010,0.3,490000,49,433161
"4051",36993,0.3,7e+05,70,433231
"4052",36986,0.3,490000,49,433280
"4053",37094,0.3,2360000,236,433516
"4054",37048,0.3,630000,63,433579
"4055",17033,0.3,7e+05,70,433649
"4056",36977,0.3,560000,56,433705
"4057",16997,0.3,1290000,129,433834
"4058",17008,0.3,7e+05,70,433904
"4060",36957,0.3,8e+05,80,433984
"4061",36990,0.3,8e+05,80,434064
"4062",17065,0.2,3950000,395,434459
"4063",17110,0.3,560000,56,434515
"4064",16943,0.166666666666667,2040000,204,434719
"4065",16998,0.3,1200000,120,434839
"4066",36942,0.3,8e+05,80,434919
"4067",37068,0.3,4550000,455,435374
"4068",36923,0.3,560000,56,435430
"4070",17046,0.3,8e+05,80,435510
"4071",37018,0.3,8e+05,80,435590
"4072",17078,0.3,2260000,226,435816
"4073",36963,0.3,7e+05,70,435886
"4074",16861,0.3,2300000,230,436116
"4075",16806,0.3,3100000,310,436426
"4076",16924,0.3,1e+06,100,436526
"4077",17120,0.2,1500000,150,436676
"4078",16742,0.3,1960000,196,436872
"4079",16850,0.3,7e+05,70,436942
"4080",16904,0.3,8e+05,80,437022
"4082",16988,0.3,1750000,175,437197
"4083",36912,0.3,1050000,105,437302
"4084",36938,0.3,2450000,245,437547
"4085",16936,0.3,560000,56,437603
"4086",16762,0.2,1490000,149,437752
"4087",36874,0.3,490000,49,437801
"4088",16887,0.3,3760000,376,438177
"4089",16654,0.3,560000,56,438233
"4093",16723,0.3,1360000,136,438369
"4094",36853,0.3,7e+05,70,438439
"4095",16828,0.3,3190000,319,438758
"4096",16729,0.3,2190000,219,438977
"4097",16653,0.2,1260000,126,439103
"4098",16444,0.3,1990000,199,439302
"4099",16763,0.3,2400000,240,439542
"4100",44459,0.3,8e+05,80,439622
"4101",16019,0.3,1e+06,100,439722
"4105",16459,0.3,560000,56,439778
"4106",16692,0.3,490000,49,439827
"4107",16679,0.2,3740000,374,440201
"4108",16677,0.3,1700000,170,440371
"4109",16249,0.3,7e+05,70,440441
"4110",16035,0.3,560000,56,440497
"4111",16190,0.3,1190000,119,440616
"4112",16308,0.3,1190000,119,440735
"4113",16283,0.2,1500000,150,440885
"4114",36781,0.3,1190000,119,441004
"4115",16034,0.166666666666667,2550000,255,441259
"4116",44433,0.3,560000,56,441315
"4117",44471,0.3,1700000,170,441485
"4118",16124,0.3,1190000,119,441604
"4119",44455,0.3,560000,56,441660
"4120",44428,0.3,7e+05,70,441730
"4122",36771,0.3,1260000,126,441856
"4123",36798,0.3,490000,49,441905
"4124",16212,0.233333333333333,6600000,660,442565
"4125",36767,0.3,490000,49,442614
"4126",36849,0.3,1050000,105,442719
"4127",16204,0.3,2450000,245,442964
"4128",36766,0.3,490000,49,443013
"4129",15912,0.3,1260000,126,443139
"4130",36678,0.3,560000,56,443195
"4131",36730,0.3,7e+05,70,443265
"4132",36710,0.3,490000,49,443314
"4133",16307,0.3,980000,98,443412
"4134",36698,0.2,3080000,308,443720
"4135",15953,0.2,1120000,112,443832
"4136",36614,0.3,490000,49,443881
"4139",15688,0.3,7e+05,70,443951
"4140",15767,0.3,7e+05,70,444021
"4142",36650,0.3,8e+05,80,444101
"4143",16434,0.3,2400000,240,444341
"4144",16343,0.3,1920000,192,444533
"4145",16241,0.3,2680000,268,444801
"4146",15946,0.2,3720000,372,445173
"4147",15852,0.3,7e+05,70,445243
"4148",16454,0.2,3760000,376,445619
"4149",15910,0.3,7e+05,70,445689
"4150",15915,0.2,2160000,216,445905
"4151",36683,0.3,7e+05,70,445975
"4152",36566,0.3,8e+05,80,446055
"4153",36654,0.3,1700000,170,446225
"4154",36623,0.3,8e+05,80,446305
"4155",36616,0.3,2860000,286,446591
"4156",36630,0.3,1e+06,100,446691
"4157",36701,0.2,1560000,156,446847
"4158",15965,0.3,1890000,189,447036
"4159",15966,0.2,2960000,296,447332
"4160",36756,0.3,7e+05,70,447402
"4161",44398,0.3,8e+05,80,447482
"4164",15470,0.3,1500000,150,447632
"4168",36793,0.3,640000,64,447696
"4169",16002,0.3,1260000,126,447822
"4170",15610,0.3,8e+05,80,447902
"4171",15848,0.3,1440000,144,448046
"4174",23859,0.2,1500000,150,448196
"4175",15580,0.166666666666667,1760000,176,448372
"4176",36668,0.3,720000,72,448444
"4177",15595,0.3,640000,64,448508
"4178",16174,0.166666666666667,3750000,375,448883
"4179",15928,0.2,1820000,182,449065
"4180",36755,0.3,4250000,425,449490
"4181",15838,0.3,3240000,324,449814
"4182",15769,0.3,1800000,180,449994
"4183",36549,0.3,1270000,127,450121
"4184",43929,0.3,1200000,120,450241
"4185",44391,0.3,640000,64,450305
"4187",15800,0.3,2080000,208,450513
"4190",15446,0.3,630000,63,450576
"4191",15497,0.3,9e+05,90,450666
"4192",15880,0.3,2960000,296,450962
"4193",36597,0.3,1350000,135,451097
"4194",15436,0.3,2090000,209,451306
"4195",15780,0.2,2520000,252,451558
"4196",36632,0.2,2070000,207,451765
"4197",15417,0.3,630000,63,451828
"4198",15451,0.3,1620000,162,451990
"4199",36540,0.3,1990000,199,452189
"4200",15387,0.3,810000,81,452270
"4201",15517,0.3,1920000,192,452462
"4202",15598,0.3,720000,72,452534
"4203",15511,0.3,3380000,338,452872
"4204",36478,0.3,1990000,199,453071
"4205",36446,0.3,9e+05,90,453161
"4206",36432,0.3,720000,72,453233
"4207",43851,0.3,1440000,144,453377
"4208",43844,0.3,1620000,162,453539
"4209",15283,0.3,720000,72,453611
"4210",15343,0.3,9e+05,90,453701
"4212",36466,0.3,8e+05,80,453781
"4213",36480,0.3,560000,56,453837
"4214",15379,0.3,1640000,164,454001
"4215",36555,0.3,2090000,209,454210
"4216",15432,0.3,640000,64,454274
"4217",36467,0.3,1120000,112,454386
"4218",23849,0.3,8e+05,80,454466
"4219",15729,0.2,2170000,217,454683
"4220",36469,0.3,640000,64,454747
"4221",15560,0.3,2800000,280,455027
"4222",36458,0.3,2090000,209,455236
"4223",15416,0.3,1290000,129,455365
"4224",15400,0.3,1360000,136,455501
"4225",36460,0.3,1700000,170,455671
"4226",36423,0.3,560000,56,455727
"4227",36696,0.166666666666667,2460000,246,455973
"4228",43816,0.3,640000,64,456037
"4229",15302,0.3,640000,64,456101
"4230",44383,0.3,8e+05,80,456181
"4231",15287,0.3,7e+05,70,456251
"4232",15301,0.3,1050000,105,456356
"4233",36497,0.233333333333333,1910000,191,456547
"4234",36448,0.3,560000,56,456603
"4235",15384,0.3,2490000,249,456852
"4236",23846,0.3,1260000,126,456978
"4237",23850,0.3,490000,49,457027
"4238",15435,0.2,1460000,146,457173
"4239",15188,0.3,490000,49,457222
"4240",36364,0.3,1190000,119,457341
"4241",36536,0.3,560000,56,457397
"4242",36427,0.3,1050000,105,457502
"4243",15250,0.3,560000,56,457558
"4244",15361,0.3,1200000,120,457678
"4245",15350,0.3,2400000,240,457918
"4246",36315,0.3,490000,49,457967
"4247",36702,0.2,7960000,796,458763
"4248",36308,0.3,560000,56,458819
"4249",15349,0.3,7e+05,70,458889
"4250",43807,0.3,560000,56,458945
"4251",43843,0.3,2380000,238,459183
"4252",43802,0.3,560000,56,459239
"4253",43806,0.3,630000,63,459302
"4254",15230,0.3,1050000,105,459407
"4255",44376,0.3,1260000,126,459533
"4257",15114,0.3,1e+06,100,459633
"4259",15344,0.3,2190000,219,459852
"4261",15185,0.3,2060000,206,460058
"4262",36353,0.3,1700000,170,460228
"4263",15214,0.3,1190000,119,460347
"4264",15006,0.3,8e+05,80,460427
"4265",36373,0.3,1500000,150,460577
"4266",15107,0.3,1e+06,100,460677
"4267",36284,0.3,1500000,150,460827
"4268",15045,0.3,1e+06,100,460927
"4269",43786,0.2,1290000,129,461056
"4270",43784,0.3,7e+05,70,461126
"4271",43778,0.3,1e+06,100,461226
"4272",14907,0.3,7e+05,70,461296
"4274",15123,0.3,7e+05,70,461366
"4276",36306,0.3,1900000,190,461556
"4277",15043,0.3,3250000,325,461881
"4278",36445,0.3,1400000,140,462021
"4279",15477,0.166666666666667,4980000,498,462519
"4280",36324,0.3,1190000,119,462638
"4281",14937,0.3,1190000,119,462757
"4283",36455,0.2,1260000,126,462883
"4284",36251,0.3,490000,49,462932
"4285",36270,0.3,560000,56,462988
"4286",15220,0.3,1190000,119,463107
"4287",14856,0.3,1050000,105,463212
"4288",14845,0.3,560000,56,463268
"4289",36303,0.3,1700000,170,463438
"4290",36250,0.3,7e+05,70,463508
"4291",14791,0.3,490000,49,463557
"4292",14885,0.2,1560000,156,463713
"4293",36282,0.3,8e+05,80,463793
"4294",36280,0.3,7e+05,70,463863
"4295",14821,0.3,1e+06,100,463963
"4296",14945,0.3,1360000,136,464099
"4297",36258,0.3,9e+05,90,464189
"4298",36227,0.3,7e+05,70,464259
"4299",15109,0.3,1700000,170,464429
"4300",14974,0.3,2260000,226,464655
"4303",14920,0.3,2400000,240,464895
"4304",36298,0.3,8e+05,80,464975
"4305",15013,0.3,2260000,226,465201
"4306",14813,0.3,1700000,170,465371
"4307",14828,0.3,7e+05,70,465441
"4308",36206,0.3,1e+06,100,465541
"4309",36166,0.3,7e+05,70,465611
"4310",14894,0.2,1490000,149,465760
"4311",14753,0.3,7e+05,70,465830
"4312",36146,0.3,1e+06,100,465930
"4313",14754,0.3,560000,56,465986
"4314",14855,0.3,490000,49,466035
"4315",36226,0.3,1190000,119,466154
"4316",14829,0.3,1360000,136,466290
"4317",36196,0.3,560000,56,466346
"4318",36143,0.3,7e+05,70,466416
"4319",15000,0.3,490000,49,466465
"4320",14782,0.3,7e+05,70,466535
"4321",14924,0.3,1260000,126,466661
"4322",36106,0.3,7e+05,70,466731
"4323",36152,0.3,7e+05,70,466801
"4324",36178,0.3,2360000,236,467037
"4325",36177,0.3,5440000,544,467581
"4326",43741,0.3,1130000,113,467694
"4327",43751,0.3,5440000,544,468238
"4328",36142,0.3,560000,56,468294
"4329",14748,0.3,1360000,136,468430
"4330",14818,0.3,5390000,539,468969
"4331",36131,0.3,3880000,388,469357
"4332",14682,0.3,2630000,263,469620
"4333",36113,0.3,640000,64,469684
"4334",14594,0.3,560000,56,469740
"4335",14589,0.3,8e+05,80,469820
"4336",36090,0.3,560000,56,469876
"4337",14572,0.3,640000,64,469940
"4338",36048,0.233333333333333,3650000,365,470305
"4339",36211,0.2,1340000,134,470439
"4340",36116,0.3,8e+05,80,470519
"4341",14776,0.3,2700000,270,470789
"4342",14775,0.3,1050000,105,470894
"4343",14761,0.3,560000,56,470950
"4344",14632,0.3,640000,64,471014
"4345",14562,0.3,560000,56,471070
"4346",14666,0.3,1050000,105,471175
"4347",14648,0.3,1050000,105,471280
"4348",14796,0.3,560000,56,471336
"4349",35990,0.3,8e+05,80,471416
"4350",36032,0.3,560000,56,471472
"4352",36243,0.3,3290000,329,471801
"4353",36071,0.3,9e+05,90,471891
"4354",14592,0.3,2150000,215,472106
"4355",36159,0.3,1450000,145,472251
"4356",36051,0.3,720000,72,472323
"4357",14474,0.3,630000,63,472386
"4358",36058,0.3,720000,72,472458
"4359",35988,0.2,1600000,160,472618
"4360",35989,0.3,720000,72,472690
"4361",36053,0.3,630000,63,472753
"4362",14373,0.3,9e+05,90,472843
"4363",14587,0.3,2160000,216,473059
"4364",35965,0.3,9e+05,90,473149
"4365",36082,0.3,720000,72,473221
"4366",36061,0.3,1990000,199,473420
"4367",35983,0.3,9e+05,90,473510
"4368",36047,0.3,9e+05,90,473600
"4369",43695,0.3,630000,63,473663
"4370",36231,0.2,6560000,656,474319
"4371",14337,0.3,8e+05,80,474399
"4372",35986,0.3,1360000,136,474535
"4373",14387,0.3,640000,64,474599
"4374",14349,0.3,560000,56,474655
"4375",36070,0.3,2090000,209,474864
"4376",36164,0.3,3770000,377,475241
"4377",14372,0.3,640000,64,475305
"4378",14297,0.3,640000,64,475369
"4379",14440,0.3,1750000,175,475544
"4380",35967,0.2,2400000,240,475784
"4382",14288,0.3,640000,64,475848
"4383",35876,0.3,1290000,129,475977
"4384",35962,0.3,1200000,120,476097
"4385",14299,0.3,1190000,119,476216
"4386",14236,0.3,560000,56,476272
"4387",35920,0.3,490000,49,476321
"4388",35930,0.3,1260000,126,476447
"4389",35985,0.3,2630000,263,476710
"4390",14167,0.3,560000,56,476766
"4391",35886,0.3,490000,49,476815
"4392",35944,0.2,1050000,105,476920
"4393",35863,0.3,1460000,146,477066
"4394",14226,0.3,1430000,143,477209
"4395",35782,0.3,490000,49,477258
"4396",14140,0.233333333333333,1960000,196,477454
"4397",35844,0.3,1680000,168,477622
"4398",14211,0.2,1460000,146,477768
"4399",35891,0.3,7e+05,70,477838
"4400",14144,0.2,2310000,231,478069
"4401",43673,0.3,1190000,119,478188
"4402",35884,0.3,7e+05,70,478258
"4403",35778,0.3,2960000,296,478554
"4404",14136,0.3,1600000,160,478714
"4405",35933,0.3,1e+06,100,478814
"4406",14228,0.3,8e+05,80,478894
"4407",35827,0.3,2700000,270,479164
"4408",35783,0.3,2260000,226,479390
"4409",14095,0.3,8e+05,80,479470
"4410",35750,0.2,2600000,260,479730
"4411",14125,0.3,1190000,119,479849
"4412",35771,0.3,1700000,170,480019
"4413",35904,0.3,4400000,440,480459
"4414",35717,0.3,1700000,170,480629
"4415",43656,0.3,8e+05,80,480709
"4416",23805,0.3,3250000,325,481034
"4417",14072,0.3,630000,63,481097
"4418",14316,0.3,2550000,255,481352
"4419",43663,0.3,7e+05,70,481422
"4420",35728,0.3,1490000,149,481571
"4421",14073,0.3,7e+05,70,481641
"4422",35848,0.233333333333333,3790000,379,482020
"4423",14248,0.2,1750000,175,482195
"4424",35940,0.3,7e+05,70,482265
"4425",35835,0.3,1890000,189,482454
"4426",35681,0.3,7e+05,70,482524
"4427",35894,0.2,1120000,112,482636
"4428",14141,0.3,7e+05,70,482706
"4429",35714,0.3,560000,56,482762
"4430",35698,0.3,630000,63,482825
"4431",35694,0.3,560000,56,482881
"4432",14127,0.2,2960000,296,483177
"4433",13976,0.3,560000,56,483233
"4434",14262,0.3,4350000,435,483668
"4435",35656,0.3,490000,49,483717
"4436",13983,0.3,1190000,119,483836
"4437",13990,0.3,7e+05,70,483906
"4438",14050,0.3,8e+05,80,483986
"4439",14353,0.2,3e+06,300,484286
"4440",13972,0.3,8e+05,80,484366
"4441",14331,0.2,1950000,195,484561
"4442",43704,0.3,1360000,136,484697
"4443",43684,0.3,1190000,119,484816
"4444",35903,0.2,2650000,265,485081
"4445",14206,0.2,2700000,270,485351
"4446",35826,0.3,1890000,189,485540
"4447",14029,0.2,1400000,140,485680
"4448",14052,0.3,1260000,126,485806
"4449",14043,0.3,8e+05,80,485886
"4450",35632,0.3,9e+05,90,485976
"4451",14015,0.3,8e+05,80,486056
"4452",35676,0.3,2390000,239,486295
"4453",13947,0.3,8e+05,80,486375
"4454",35651,0.3,7e+05,70,486445
"4455",35890,0.3,3690000,369,486814
"4456",35605,0.3,7e+05,70,486884
"4458",13884,0.3,490000,49,486933
"4459",35675,0.3,1190000,119,487052
"4460",13871,0.2,1260000,126,487178
"4461",43631,0.3,560000,56,487234
"4462",13845,0.3,490000,49,487283
"4463",14020,0.3,2060000,206,487489
"4464",35602,0.3,490000,49,487538
"4465",35722,0.3,1190000,119,487657
"4466",35663,0.3,1190000,119,487776
"4467",13926,0.3,490000,49,487825
"4468",35658,0.3,630000,63,487888
"4469",43628,0.3,7e+05,70,487958
"4470",14091,0.2,1890000,189,488147
"4471",13882,0.3,490000,49,488196
"4472",13802,0.3,490000,49,488245
"4473",13968,0.166666666666667,5580000,558,488803
"4474",35630,0.3,1190000,119,488922
"4475",35496,0.3,1260000,126,489048
"4476",35483,0.3,490000,49,489097
"4477",35610,0.3,1360000,136,489233
"4478",14027,0.3,2380000,238,489471
"4479",14086,0.3,5290000,529,490000
"4480",35507,0.3,1610000,161,490161
"4481",13725,0.3,490000,49,490210
"4482",35604,0.3,560000,56,490266
"4483",35555,0.3,8e+05,80,490346
"4484",35536,0.3,1200000,120,490466
"4485",13920,0.3,3260000,326,490792
"4486",13986,0.3,720000,72,490864
"4487",43618,0.3,1200000,120,490984
"4488",35563,0.3,1560000,156,491140
"4489",35481,0.3,8e+05,80,491220
"4490",35705,0.2,3060000,306,491526
"4491",35539,0.3,1050000,105,491631
"4492",13850,0.3,4890000,489,492120
"4493",13815,0.3,2500000,250,492370
"4494",23795,0.3,8e+05,80,492450
"4495",13663,0.3,560000,56,492506
"4496",13921,0.2,3400000,340,492846
"4497",13733,0.3,1990000,199,493045
"4498",13796,0.3,1620000,162,493207
"4499",13817,0.3,1440000,144,493351
"4500",35457,0.2,1260000,126,493477
"4501",13778,0.3,7e+05,70,493547
"4502",13798,0.166666666666667,2190000,219,493766
"4503",35640,0.3,1800000,180,493946
"4504",13647,0.3,8e+05,80,494026
"4505",13916,0.3,2310000,231,494257
"4506",35513,0.3,2250000,225,494482
"4507",13787,0.3,1700000,170,494652
"4508",35495,0.3,8e+05,80,494732
"4509",35439,0.3,2440000,244,494976
"4510",13724,0.3,7e+05,70,495046
"4511",35341,0.3,1500000,150,495196
"4512",36002,0.3,5550000,555,495751
"4513",43587,0.3,7e+05,70,495821
"4514",13610,0.3,7e+05,70,495891
"4515",13576,0.3,490000,49,495940
"4516",35609,0.3,2560000,256,496196
"4517",35518,0.3,1530000,153,496349
"4518",43735,0.3,11710000,1171,497520
"4519",43602,0.3,1190000,119,497639
"4520",43594,0.3,2260000,226,497865
"4521",35357,0.3,560000,56,497921
"4522",13820,0.3,630000,63,497984
"4523",13581,0.3,560000,56,498040
"4524",43632,0.2,1190000,119,498159
"4525",43574,0.3,7e+05,70,498229
"4526",35325,0.3,490000,49,498278
"4527",13748,0.3,560000,56,498334
"4528",35346,0.3,7e+05,70,498404
"4529",35173,0.3,490000,49,498453
"4530",35204,0.3,560000,56,498509
"4531",35577,0.3,13850000,1385,499894
"4532",13355,0.3,490000,49,499943
"4533",13524,0.3,2260000,226,500169
"4534",13707,0.3,8e+05,80,500249
"4535",13640,0.3,1e+06,100,500349
"4536",35469,0.3,3560000,356,500705
"4537",35193,0.3,1430000,143,500848
"4538",35353,0.3,7e+05,70,500918
"4539",13643,0.3,1e+06,100,501018
"4540",13495,0.3,8e+05,80,501098
"4541",43626,0.3,3690000,369,501467
"4542",35322,0.2,3200000,320,501787
"4543",35221,0.3,8e+05,80,501867
"4544",13577,0.3,2190000,219,502086
"4545",13422,0.3,1e+06,100,502186
"4546",13361,0.3,7e+05,70,502256
"4547",13442,0.3,8e+05,80,502336
"4548",13629,0.3,1e+06,100,502436
"4549",13562,0.3,2550000,255,502691
"4550",35097,0.3,7e+05,70,502761
"4551",13757,0.3,5060000,506,503267
"4552",13241,0.3,7e+05,70,503337
"4553",13250,0.3,4090000,409,503746
"4554",35080,0.3,1960000,196,503942
"4555",13463,0.3,8e+05,80,504022
"4556",13699,0.3,3110000,311,504333
"4557",43538,0.3,490000,49,504382
"4558",13302,0.25,2380000,238,504620
"4559",35270,0.3,2260000,226,504846
"4560",35101,0.3,560000,56,504902
"4561",13604,0.3,1680000,168,505070
"4562",35161,0.3,560000,56,505126
"4563",43525,0.3,7e+05,70,505196
"4564",13285,0.3,490000,49,505245
"4565",13240,0.3,560000,56,505301
"4566",13059,0.3,7e+05,70,505371
"4567",34967,0.3,490000,49,505420
"4568",13258,0.2,1400000,140,505560
"4569",35200,0.3,3590000,359,505919
"4570",35262,0.3,7010000,701,506620
"4571",13539,0.3,560000,56,506676
"4572",13066,0.3,1190000,119,506795
"4573",23763,0.3,560000,56,506851
"4574",13135,0.2,2450000,245,507096
"4575",34984,0.166666666666667,4190000,419,507515
"4576",35314,0.3,4810000,481,507996
"4577",13017,0.3,630000,63,508059
"4578",13280,0.3,560000,56,508115
"4579",35172,0.3,2240000,224,508339
"4580",13050,0.2,3560000,356,508695
"4581",34947,0.2,2050000,205,508900
"4582",34958,0.3,7e+05,70,508970
"4583",13061,0.3,1490000,149,509119
"4584",13192,0.3,1190000,119,509238
"4585",13130,0.3,1540000,154,509392
"4586",12830,0.3,560000,56,509448
"4587",12865,0.3,7e+05,70,509518
"4588",13259,0.3,1120000,112,509630
"4589",35085,0.2,2480000,248,509878
"4590",35055,0.3,1820000,182,510060
"4591",23759,0.3,560000,56,510116
"4592",13208,0.3,8e+05,80,510196
"4593",12891,0.3,8e+05,80,510276
"4594",12884,0.3,9e+05,90,510366
"4595",34864,0.3,2330000,233,510599
"4596",43498,0.3,7e+05,70,510669
"4597",43514,0.3,1520000,152,510821
"4598",43524,0.3,9e+05,90,510911
"4599",34861,0.3,8e+05,80,510991
"4600",13154,0.3,2500000,250,511241
"4601",35032,0.3,7e+05,70,511311
"4602",34819,0.3,8e+05,80,511391
"4603",34857,0.3,1e+06,100,511491
"4604",34768,0.3,8e+05,80,511571
"4605",12728,0.3,8e+05,80,511651
"4607",35119,0.2,2650000,265,511916
"4608",13311,0.2,1440000,144,512060
"4609",34766,0.3,1360000,136,512196
"4610",34741,0.2,1540000,154,512350
"4611",12703,0.3,8e+05,80,512430
"4612",35116,0.166666666666667,4390000,439,512869
"4613",12610,0.3,640000,64,512933
"4614",43492,0.3,640000,64,512997
"4615",13175,0.2,1540000,154,513151
"4616",12605,0.3,1920000,192,513343
"4617",43495,0.3,1360000,136,513479
"4618",34785,0.3,640000,64,513543
"4619",12637,0.3,560000,56,513599
"4620",34751,0.3,2070000,207,513806
"4621",34679,0.3,1990000,199,514005
"4622",12592,0.3,560000,56,514061
"4623",34692,0.3,2170000,217,514278
"4624",34631,0.3,4160000,416,514694
"4625",34687,0.3,1.8e+07,1800,516494
"4628",34738,0.3,2420000,242,516736
"4629",34673,0.3,9e+05,90,516826
"4630",12729,0.2,1280000,128,516954
"4631",12445,0.3,1120000,112,517066
"4632",34697,0.3,1430000,143,517209
"4633",12711,0.3,2700000,270,517479
"4634",34663,0.3,2420000,242,517721
"4635",12570,0.3,1360000,136,517857
"4636",12440,0.3,1990000,199,518056
"4637",23748,0.3,9e+05,90,518146
"4638",12700,0.3,1190000,119,518265
"4639",34760,0.3,1200000,120,518385
"4640",12454,0.2,1440000,144,518529
"4641",34635,0.3,560000,56,518585
"4642",12450,0.3,1700000,170,518755
"4643",34753,0.3,7620000,762,519517
"4644",34467,0.3,8e+05,80,519597
"4645",12271,0.3,5360000,536,520133
"4646",12188,0.3,560000,56,520189
"4647",43367,0.3,1190000,119,520308
"4648",43407,0.3,7e+05,70,520378
"4649",34639,0.3,1050000,105,520483
"4650",12321,0.3,1960000,196,520679
"4651",11959,0.3,560000,56,520735
"4652",34353,0.3,7e+05,70,520805
"4653",12161,0.3,2630000,263,521068
"4654",34428,0.3,1700000,170,521238
"4655",12083,0.3,8e+05,80,521318
"4656",34453,0.3,1700000,170,521488
"4657",13704,0.14,5930000,593,522081
"4659",43348,0.3,7e+05,70,522151
"4660",12022,0.3,1e+06,100,522251
"4661",43398,0.3,8e+05,80,522331
"4662",12009,0.3,7e+05,70,522401
"4663",11958,0.2,1500000,150,522551
"4664",34277,0.3,8e+05,80,522631
"4665",34562,0.3,8300000,830,523461
"4666",12000,0.3,7e+05,70,523531
"4667",34188,0.3,8e+05,80,523611
"4668",11953,0.3,7e+05,70,523681
"4669",12164,0.3,490000,49,523730
"4672",34501,0.2,4040000,404,524134
"4673",12093,0.2,1400000,140,524274
"4674",34489,0.3,7e+06,700,524974
"4675",34170,0.3,1190000,119,525093
"4676",11833,0.3,1290000,129,525222
"4677",11865,0.3,560000,56,525278
"4678",43328,0.3,560000,56,525334
"4679",34238,0.3,8e+05,80,525414
"4681",34262,0.3,8e+05,80,525494
"4682",11862,0.3,8e+05,80,525574
"4683",34331,0.3,2560000,256,525830
"4684",11880,0.3,8e+05,80,525910
"4685",34502,0.2,2260000,226,526136
"4686",11978,0.3,560000,56,526192
"4687",34122,0.3,8e+05,80,526272
"4688",34268,0.2,1770000,177,526449
"4689",34243,0.3,560000,56,526505
"4690",12220,0.3,4420000,442,526947
"4691",34152,0.3,4730000,473,527420
"4692",34296,0.3,3750000,375,527795
"4693",11662,0.3,1520000,152,527947
"4694",11687,0.3,8e+05,80,528027
"4695",43331,0.3,2890000,289,528316
"4698",11787,0.3,9e+05,90,528406
"4699",34108,0.3,630000,63,528469
"4700",34259,0.3,3030000,303,528772
"4701",34249,0.3,1680000,168,528940
"4702",11779,0.3,9e+05,90,529030
"4703",21549,0.3,630000,63,529093
"4704",21563,0.3,1620000,162,529255
"4705",11834,0.3,1360000,136,529391
"4706",11802,0.3,1460000,146,529537
"4707",34064,0.3,630000,63,529600
"4708",34276,0.3,630000,63,529663
"4709",11674,0.3,630000,63,529726
"4710",34043,0.2,1990000,199,529925
"4711",11746,0.3,1700000,170,530095
"4712",34042,0.2,1900000,190,530285
"4713",11777,0.3,9e+05,90,530375
"4714",34017,0.3,630000,63,530438
"4715",11652,0.3,2260000,226,530664
"4716",11867,0.3,4530000,453,531117
"4717",11676,0.3,8e+05,80,531197
"4718",43303,0.3,560000,56,531253
"4719",11725,0.3,2690000,269,531522
"4720",11743,0.3,560000,56,531578
"4721",11921,0.2,2720000,272,531850
"4722",11795,0.3,560000,56,531906
"4723",11695,0.3,8e+05,80,531986
"4724",11729,0.3,1360000,136,532122
"4725",11774,0.3,2e+06,200,532322
"4726",11830,0.2,1280000,128,532450
"4727",21554,0.3,1920000,192,532642
"4728",34140,0.3,3530000,353,532995
"4729",21557,0.3,3250000,325,533320
"4730",21537,0.3,560000,56,533376
"4731",11665,0.3,8e+05,80,533456
"4732",21532,0.3,560000,56,533512
"4733",11723,0.3,1360000,136,533648
"4734",34093,0.3,720000,72,533720
"4735",11686,0.3,1700000,170,533890
"4736",11584,0.3,640000,64,533954
"4737",34078,0.3,4650000,465,534419
"4738",43296,0.3,2890000,289,534708
"4739",11745,0.3,1360000,136,534844
"4740",11831,0.3,1700000,170,535014
"4741",11539,0.3,1360000,136,535150
"4742",43222,0.3,560000,56,535206
"4743",11465,0.3,640000,64,535270
"4744",43308,0.3,1e+06,100,535370
"4745",43290,0.3,1e+06,100,535470
"4746",11626,0.3,1500000,150,535620
"4749",33991,0.2,3690000,369,535989
"4750",11848,0.3,8e+05,80,536069
"4751",34047,0.3,1e+06,100,536169
"4752",33935,0.3,1e+06,100,536269
"4753",34113,0.3,3860000,386,536655
"4754",11558,0.3,8e+05,80,536735
"4755",34015,0.3,1e+06,100,536835
"4756",11846,0.3,7e+05,70,536905
"4757",11836,0.2,3160000,316,537221
"4758",33958,0.3,8e+05,80,537301
"4759",11778,0.3,2060000,206,537507
"4760",33922,0.3,1500000,150,537657
"4761",33973,0.3,1800000,180,537837
"4762",33904,0.3,8e+05,80,537917
"4763",11635,0.3,1260000,126,538043
"4764",11497,0.3,1e+06,100,538143
"4765",34150,0.3,4860000,486,538629
"4766",11355,0.3,1e+06,100,538729
"4769",43183,0.3,1400000,140,538869
"4770",11769,0.3,1360000,136,539005
"4771",11677,0.3,5420000,542,539547
"4772",34036,0.3,1190000,119,539666
"4773",11722,0.14,8530000,853,540519
"4775",34114,0.3,1190000,119,540638
"4776",33934,0.3,1050000,105,540743
"4777",33898,0.3,1260000,126,540869
"4778",34045,0.3,4500000,450,541319
"4779",33986,0.3,2360000,236,541555
"4780",34155,0.3,490000,49,541604
"4781",33903,0.3,490000,49,541653
"4782",11446,0.3,1400000,140,541793
"4783",34103,0.3,560000,56,541849
"4784",11402,0.3,490000,49,541898
"4785",33949,0.3,1990000,199,542097
"4786",33827,0.3,490000,49,542146
"4787",33916,0.3,1750000,175,542321
"4788",11486,0.15,3080000,308,542629
"4789",11332,0.3,7e+05,70,542699
"4790",33886,0.3,1360000,136,542835
"4791",11381,0.3,490000,49,542884
"4793",11514,0.166666666666667,2450000,245,543129
"4794",11517,0.3,1400000,140,543269
"4795",11410,0.3,560000,56,543325
"4796",33863,0.3,490000,49,543374
"4797",11533,0.2,1260000,126,543500
"4798",11414,0.2,5010000,501,544001
"4799",33870,0.166666666666667,6680000,668,544669
"4800",33854,0.3,490000,49,544718
"4801",21506,0.3,7e+05,70,544788
"4802",11476,0.3,1120000,112,544900
"4803",33885,0.3,7e+05,70,544970
"4804",33992,0.3,1680000,168,545138
"4805",11409,0.2,1750000,175,545313
"4806",11432,0.3,1980000,198,545511
"4807",33754,0.3,560000,56,545567
"4808",11261,0.3,7e+05,70,545637
"4809",11595,0.3,4720000,472,546109
"4810",11221,0.3,1260000,126,546235
"4811",43173,0.3,490000,49,546284
"4812",43205,0.3,7e+05,70,546354
"4813",43242,0.3,1190000,119,546473
"4814",11128,0.3,560000,56,546529
"4815",11184,0.3,7e+05,70,546599
"4816",11178,0.3,490000,49,546648
"4817",11161,0.3,490000,49,546697
"4818",33828,0.3,7e+05,70,546767
"4819",11366,0.3,2750000,275,547042
"4820",33727,0.3,9e+05,90,547132
"4821",11286,0.3,1e+06,100,547232
"4822",11215,0.233333333333333,5050000,505,547737
"4823",11174,0.3,7e+05,70,547807
"4824",21490,0.3,1e+06,100,547907
"4825",33847,0.166666666666667,2050000,205,548112
"4826",11254,0.2,3200000,320,548432
"4827",33881,0.166666666666667,1890000,189,548621
"4828",11196,0.3,7e+05,70,548691
"4829",33701,0.2,1290000,129,548820
"4830",33738,0.3,2360000,236,549056
"4831",43155,0.3,1500000,150,549206
"4832",33667,0.2,3190000,319,549525
"4833",11287,0.3,7e+05,70,549595
"4834",11212,0.3,2060000,206,549801
"4835",11503,0.3,7140000,714,550515
"4836",11067,0.3,2960000,296,550811
"4837",11043,0.3,1430000,143,550954
"4838",11013,0.3,7e+05,70,551024
"4839",11349,0.2,5740000,574,551598
"4840",11571,0.2,1500000,150,551748
"4841",11145,0.3,7e+05,70,551818
"4842",33695,0.2,2e+06,200,552018
"4843",33769,0.3,1890000,189,552207
"4844",21487,0.3,7e+05,70,552277
"4845",11165,0.3,560000,56,552333
"4846",21500,0.3,2260000,226,552559
"4847",33690,0.3,560000,56,552615
"4848",33826,0.2,1400000,140,552755
"4849",11379,0.2,2060000,206,552961
"4850",33583,0.3,490000,49,553010
"4851",33681,0.3,560000,56,553066
"4852",33772,0.3,630000,63,553129
"4853",33748,0.3,1750000,175,553304
"4854",33869,0.166666666666667,2660000,266,553570
"4855",11199,0.3,2650000,265,553835
"4856",11118,0.3,1750000,175,554010
"4857",11096,0.3,490000,49,554059
"4858",33706,0.2,9360000,936,554995
"4859",33569,0.3,560000,56,555051
"4860",33610,0.3,3460000,346,555397
"4861",11124,0.3,490000,49,555446
"4862",11154,0.3,2190000,219,555665
"4863",11139,0.3,1700000,170,555835
"4864",11025,0.3,1360000,136,555971
"4865",11058,0.3,1e+06,100,556071
"4866",33666,0.3,1750000,175,556246
"4867",11195,0.3,1e+06,100,556346
"4868",11081,0.3,1e+06,100,556446
"4869",11413,0.2,3210000,321,556767
"4870",33532,0.3,3160000,316,557083
"4871",33492,0.3,7e+05,70,557153
"4872",11041,0.3,1190000,119,557272
"4873",43133,0.3,8e+05,80,557352
"4874",43112,0.3,8e+05,80,557432
"4875",43137,0.3,1e+06,100,557532
"4876",33619,0.3,4030000,403,557935
"4877",11009,0.3,7e+05,70,558005
"4878",43115,0.2,1560000,156,558161
"4879",11091,0.3,3500000,350,558511
"4880",11016,0.3,1440000,144,558655
"4881",11112,0.3,2500000,250,558905
"4882",33597,0.3,560000,56,558961
"4883",11071,0.3,640000,64,559025
"4884",11206,0.3,2e+06,200,559225
"4885",33673,0.3,8e+05,80,559305
"4886",21461,0.3,640000,64,559369
"4887",10981,0.3,1360000,136,559505
"4888",11023,0.233333333333333,2820000,282,559787
"4889",33405,0.3,560000,56,559843
"4890",10990,0.3,640000,64,559907
"4891",33433,0.2,3950000,395,560302
"4892",11225,0.2,2850000,285,560587
"4893",10982,0.3,8e+05,80,560667
"4894",11050,0.233333333333333,2920000,292,560959
"4895",11084,0.3,640000,64,561023
"4896",43102,0.3,1200000,120,561143
"4897",10909,0.2,1360000,136,561279
"4898",10912,0.3,560000,56,561335
"4899",10817,0.2,1200000,120,561455
"4900",43090,0.3,8e+05,80,561535
"4901",43070,0.3,640000,64,561599
"4902",10738,0.3,720000,72,561671
"4903",33653,0.3,560000,56,561727
"4904",10848,0.3,560000,56,561783
"4905",33504,0.3,7e+05,70,561853
"4906",21452,0.3,2680000,268,562121
"4907",10836,0.3,7e+05,70,562191
"4908",33435,0.3,7e+05,70,562261
"4909",10928,0.2,1290000,129,562390
"4910",33457,0.3,1200000,120,562510
"4911",33448,0.3,1500000,150,562660
"4912",33346,0.3,7e+05,70,562730
"4913",33340,0.3,6190000,619,563349
"4914",10896,0.3,560000,56,563405
"4915",33539,0.233333333333333,4590000,459,563864
"4916",43146,0.3,7e+05,70,563934
"4917",33280,0.3,560000,56,563990
"4918",10691,0.3,560000,56,564046
"4919",10765,0.3,8e+05,80,564126
"4921",11088,0.2,4820000,482,564608
"4922",33321,0.3,1e+06,100,564708
"4923",10766,0.2,2160000,216,564924
"4924",10775,0.3,1500000,150,565074
"4925",10808,0.2,3500000,350,565424
"4926",10767,0.3,7e+05,70,565494
"4927",10732,0.3,8e+05,80,565574
"4928",33300,0.3,7e+05,70,565644
"4929",10926,0.3,4550000,455,566099
"4930",10798,0.3,2190000,219,566318
"4931",33422,0.3,4650000,465,566783
"4932",10717,0.3,1500000,150,566933
"4933",33339,0.3,1e+06,100,567033
"4934",33437,0.2,3750000,375,567408
"4935",10929,0.166666666666667,3380000,338,567746
"4936",33259,0.3,1800000,180,567926
"4937",10728,0.3,2330000,233,568159
"4938",10689,0.3,490000,49,568208
"4939",10725,0.3,7e+05,70,568278
"4940",33316,0.3,1700000,170,568448
"4941",33332,0.3,1190000,119,568567
"4943",10746,0.3,1190000,119,568686
"4944",10719,0.3,490000,49,568735
"4945",10744,0.3,7e+05,70,568805
"4946",10758,0.3,1750000,175,568980
"4947",33273,0.3,7e+05,70,569050
"4948",10759,0.3,560000,56,569106
"4949",21425,0.3,560000,56,569162
"4950",10856,0.3,7e+05,70,569232
"4951",10659,0.3,1190000,119,569351
"4952",33336,0.3,3620000,362,569713
"4953",33304,0.233333333333333,2050000,205,569918
"4955",33469,0.3,6990000,699,570617
"4956",43165,0.3,9700000,970,571587
"4958",33201,0.15,3050000,305,571892
"4959",10641,0.3,7e+05,70,571962
"4960",10521,0.3,630000,63,572025
"4961",33231,0.3,490000,49,572074
"4962",10645,0.3,7e+05,70,572144
"4963",10643,0.3,7e+05,70,572214
"4964",33248,0.3,2290000,229,572443
"4965",33295,0.3,1050000,105,572548
"4966",10613,0.3,1260000,126,572674
"4967",43035,0.3,490000,49,572723
"4968",21429,0.3,1920000,192,572915
"4969",33246,0.3,7e+05,70,572985
"4970",33326,0.3,560000,56,573041
"4971",33297,0.3,980000,98,573139
"4972",33345,0.3,3320000,332,573471
"4973",33425,0.3,980000,98,573569
"4974",33263,0.3,490000,49,573618
"4975",10679,0.3,490000,49,573667
"4976",21438,0.3,4460000,446,574113
"4977",33228,0.3,4620000,462,574575
"4978",33279,0.3,1120000,112,574687
"4979",10557,0.3,490000,49,574736
"4980",10950,0.133333333333333,8410000,841,575577
"4981",10741,0.3,3950000,395,575972
"4982",33206,0.3,1260000,126,576098
"4983",10597,0.3,1120000,112,576210
"4984",33200,0.3,1960000,196,576406
"4985",33142,0.3,630000,63,576469
"4986",33161,0.3,560000,56,576525
"4987",10614,0.3,7e+05,70,576595
"4988",33181,0.2,1630000,163,576758
"4989",10635,0.2,1340000,134,576892
"4990",43027,0.3,2260000,226,577118
"4991",10503,0.3,7e+05,70,577188
"4992",33239,0.3,1e+06,100,577288
"4993",33267,0.3,2550000,255,577543
"4994",10633,0.3,1e+06,100,577643
"4995",33238,0.3,1700000,170,577813
"4996",10571,0.3,7e+05,70,577883
"4997",21414,0.3,8e+05,80,577963
"4998",10611,0.3,3930000,393,578356
"4999",10532,0.2,3800000,380,578736
"5000",33169,0.3,7e+05,70,578806
"5001",33202,0.3,1e+06,100,578906
"5002",10472,0.2,1340000,134,579040
"5003",10485,0.3,8e+05,80,579120
"5004",10740,0.2,2060000,206,579326
"5005",10424,0.3,2270000,227,579553
"5006",33203,0.3,1500000,150,579703
"5007",43000,0.3,1e+06,100,579803
"5008",42988,0.3,1e+06,100,579903
"5009",10359,0.3,8e+05,80,579983
"5010",10550,0.3,1360000,136,580119
"5011",10470,0.3,640000,64,580183
"5012",33146,0.3,8e+05,80,580263
"5013",10499,0.3,1460000,146,580409
"5014",33215,0.3,1440000,144,580553
"5015",10440,0.3,8e+05,80,580633
"5016",21421,0.3,3750000,375,581008
"5017",33109,0.3,640000,64,581072
"5018",33067,0.3,640000,64,581136
"5019",33121,0.3,560000,56,581192
"5020",44317,0.3,640000,64,581256
"5021",10598,0.3,8e+05,80,581336
"5022",10417,0.3,8e+05,80,581416
"5023",10564,0.3,2260000,226,581642
"5024",33119,0.3,14200000,1420,583062
"5025",10471,0.3,8e+05,80,583142
"5026",10357,0.3,630000,63,583205
"5027",10332,0.3,9e+05,90,583295
"5028",42955,0.3,2380000,238,583533
"5029",10556,0.166666666666667,2050000,205,583738
"5030",10492,0.3,2820000,282,584020
"5031",10554,0.3,3580000,358,584378
"5032",10425,0.3,720000,72,584450
"5033",33089,0.3,2730000,273,584723
"5034",33023,0.3,9e+05,90,584813
"5035",10305,0.3,630000,63,584876
"5036",33006,0.166666666666667,2270000,227,585103
"5037",44306,0.3,720000,72,585175
"5038",33088,0.3,2260000,226,585401
"5039",32960,0.3,2730000,273,585674
"5040",10258,0.2,2330000,233,585907
"5041",42928,0.233333333333333,2470000,247,586154
"5042",10506,0.233333333333333,2140000,214,586368
"5043",10702,0.2,4690000,469,586837
"5044",33003,0.2,1120000,112,586949
"5045",10320,0.3,640000,64,587013
"5046",33009,0.3,1360000,136,587149
"5047",10447,0.3,2560000,256,587405
"5048",33011,0.3,640000,64,587469
"5049",33245,0.3,4140000,414,587883
"5050",32973,0.3,560000,56,587939
"5051",10313,0.3,8e+05,80,588019
"5052",32952,0.3,560000,56,588075
"5053",10254,0.3,640000,64,588139
"5054",33244,0.3,3850000,385,588524
"5055",32992,0.3,5060000,506,589030
"5056",32993,0.166666666666667,5940000,594,589624
"5057",32916,0.3,560000,56,589680
"5058",42932,0.2,5410000,541,590221
"5059",32906,0.3,560000,56,590277
"5060",10189,0.3,560000,56,590333
"5061",42910,0.3,640000,64,590397
"5062",10480,0.3,3600000,360,590757
"5063",10228,0.3,560000,56,590813
"5064",10380,0.2,2860000,286,591099
"5065",10279,0.3,490000,49,591148
"5066",32987,0.3,3110000,311,591459
"5067",32970,0.3,7e+05,70,591529
"5068",32909,0.3,560000,56,591585
"5069",10182,0.3,490000,49,591634
"5070",32884,0.3,1260000,126,591760
"5071",10198,0.3,4470000,447,592207
"5072",32892,0.3,1190000,119,592326
"5073",10170,0.3,560000,56,592382
"5074",42925,0.3,7e+05,70,592452
"5075",10282,0.2,2190000,219,592671
"5076",32910,0.233333333333333,3900000,390,593061
"5077",42969,0.2,7850000,785,593846
"5078",10132,0.3,1750000,175,594021
"5079",42922,0.2,2620000,262,594283
"5080",10328,0.3,4640000,464,594747
"5081",33064,0.3,4680000,468,595215
"5082",32915,0.3,1700000,170,595385
"5083",32949,0.3,8e+05,80,595465
"5084",32878,0.3,7e+05,70,595535
"5085",10175,0.3,1e+06,100,595635
"5086",10211,0.3,8e+05,80,595715
"5087",10126,0.3,8e+05,80,595795
"5088",32834,0.3,1e+06,100,595895
"5089",10088,0.3,2500000,250,596145
"5090",32826,0.3,1360000,136,596281
"5091",42897,0.3,8e+05,80,596361
"5092",32795,0.2,2190000,219,596580
"5093",10124,0.3,7e+05,70,596650
"5094",32816,0.3,490000,49,596699
"5095",32809,0.3,560000,56,596755
"5096",10103,0.3,490000,49,596804
"5097",32920,0.3,2890000,289,597093
"5098",32761,0.3,7e+05,70,597163
"5099",32740,0.3,1260000,126,597289
"5100",10065,0.3,490000,49,597338
"5101",42887,0.3,560000,56,597394
"5102",10031,0.3,7e+05,70,597464
"5103",10194,0.2,980000,98,597562
"5104",32794,0.3,1050000,105,597667
"5105",32720,0.3,7e+05,70,597737
"5106",32729,0.3,630000,63,597800
"5107",10249,0.133333333333333,5340000,534,598334
"5108",42895,0.3,4110000,411,598745
"5109",42882,0.3,560000,56,598801
"5110",10090,0.3,7e+05,70,598871
"5111",32764,0.3,7e+05,70,598941
"5112",32785,0.3,8e+05,80,599021
"5113",10082,0.3,1e+06,100,599121
"5114",32782,0.3,1260000,126,599247
"5115",33016,0.3,2860000,286,599533
"5116",10085,0.3,7e+05,70,599603
"5117",32789,0.3,1700000,170,599773
"5118",32838,0.3,1190000,119,599892
"5119",10247,0.3,8e+05,80,599972
"5120",10057,0.3,1e+06,100,600072
"5121",10062,0.3,1360000,136,600208
"5122",32659,0.3,8e+05,80,600288
"5123",32661,0.3,1e+06,100,600388
"5124",9918,0.3,1e+06,100,600488
"5125",10069,0.3,1500000,150,600638
"5126",10029,0.3,7e+05,70,600708
"5127",32725,0.3,1850000,185,600893
"5128",9976,0.3,9e+05,90,600983
"5129",32842,0.2,5540000,554,601537
"5130",32654,0.3,1e+06,100,601637
"5131",10071,0.3,2500000,250,601887
"5132",9988,0.2,1750000,175,602062
"5133",10056,0.3,490000,49,602111
"5134",10178,0.2,1190000,119,602230
"5135",32742,0.2,1560000,156,602386
"5136",9975,0.3,4290000,429,602815
"5137",9908,0.3,3450000,345,603160
"5138",44296,0.3,490000,49,603209
"5139",32624,0.3,560000,56,603265
"5140",9856,0.3,7e+05,70,603335
"5141",32767,0.3,2400000,240,603575
"5142",10094,0.2,1490000,149,603724
"5143",9800,0.3,560000,56,603780
"5144",9874,0.3,2190000,219,603999
"5145",9982,0.3,1340000,134,604133
"5146",32777,0.3,640000,64,604197
"5147",10054,0.3,560000,56,604253
"5148",21381,0.3,560000,56,604309
"5149",32754,0.3,3590000,359,604668
"5150",32626,0.3,1500000,150,604818
"5151",32665,0.3,1050000,105,604923
"5152",42899,0.3,6590000,659,605582
"5153",32529,0.3,640000,64,605646
"5154",32520,0.3,8e+05,80,605726
"5155",32437,0.3,8e+05,80,605806
"5156",32453,0.3,8e+05,80,605886
"5157",32622,0.3,1920000,192,606078
"5158",32561,0.3,1500000,150,606228
"5159",9964,0.3,8e+05,80,606308
"5160",9808,0.3,1800000,180,606488
"5161",32613,0.3,3240000,324,606812
"5162",32607,0.3,8e+05,80,606892
"5163",32590,0.3,3700000,370,607262
"5164",42885,0.3,8e+05,80,607342
"5165",32732,0.2,2260000,226,607568
"5166",32363,0.3,8e+05,80,607648
"5167",32361,0.3,1e+06,100,607748
"5168",9545,0.3,7e+05,70,607818
"5169",32346,0.3,8e+05,80,607898
"5170",32329,0.3,1e+06,100,607998
"5173",9518,0.3,1e+06,100,608098
"5174",32295,0.3,8e+05,80,608178
"5175",9787,0.3,8e+05,80,608258
"5176",9707,0.3,1050000,105,608363
"5177",9751,0.3,490000,49,608412
"5178",9649,0.3,560000,56,608468
"5179",9616,0.3,490000,49,608517
"5180",32380,0.3,1890000,189,608706
"5181",9571,0.2,1120000,112,608818
"5182",32614,0.3,3060000,306,609124
"5183",42848,0.3,490000,49,609173
"5184",9645,0.3,7e+05,70,609243
"5185",42831,0.3,490000,49,609292
"5186",42828,0.3,1400000,140,609432
"5187",9588,0.3,490000,49,609481
"5188",9506,0.3,7e+05,70,609551
"5189",32204,0.3,490000,49,609600
"5190",32215,0.3,560000,56,609656
"5191",9501,0.3,7e+05,70,609726
"5192",9378,0.3,490000,49,609775
"5193",9406,0.3,560000,56,609831
"5194",9657,0.3,1190000,119,609950
"5195",9759,0.3,7e+05,70,610020
"5196",32241,0.3,560000,56,610076
"5197",9440,0.3,560000,56,610132
"5198",32448,0.3,1190000,119,610251
"5199",9453,0.3,8e+05,80,610331
"5200",9509,0.3,1e+06,100,610431
"5201",9496,0.3,7e+05,70,610501
"5202",32537,0.3,2550000,255,610756
"5203",32540,0.3,7e+05,70,610826
"5204",9784,0.2,1700000,170,610996
"5205",32342,0.3,2750000,275,611271
"5206",32289,0.3,1750000,175,611446
"5207",9525,0.3,8e+05,80,611526
"5208",9383,0.3,2200000,220,611746
"5209",32173,0.3,7e+05,70,611816
"5210",32144,0.3,8e+05,80,611896
"5211",9331,0.3,1e+06,100,611996
"5212",9351,0.3,7e+05,70,612066
"5213",9350,0.3,8e+05,80,612146
"5214",32100,0.3,2050000,205,612351
"5215",9456,0.3,9e+05,90,612441
"5216",32416,0.3,4690000,469,612910
"5217",32320,0.2,1500000,150,613060
"5218",9793,0.3,490000,49,613109
"5219",9365,0.2,3060000,306,613415
"5220",32118,0.2,1120000,112,613527
"5221",32218,0.3,3690000,369,613896
"5222",42789,0.2,2190000,219,614115
"5223",32074,0.3,490000,49,614164
"5225",32129,0.2,2360000,236,614400
"5226",32096,0.3,1990000,199,614599
"5227",32222,0.3,4460000,446,615045
"5228",32323,0.3,3810000,381,615426
"5229",32148,0.3,4880000,488,615914
"5230",9139,0.3,560000,56,615970
"5231",42724,0.3,560000,56,616026
"5232",42800,0.3,1610000,161,616187
"5233",32019,0.3,7e+05,70,616257
"5234",32085,0.3,2240000,224,616481
"5235",9230,0.2,1260000,126,616607
"5236",9063,0.2,1190000,119,616726
"5237",9050,0.3,490000,49,616775
"5238",9075,0.3,560000,56,616831
"5239",32040,0.3,630000,63,616894
"5240",9273,0.3,1120000,112,617006
"5241",9127,0.3,1190000,119,617125
"5242",32024,0.2,1540000,154,617279
"5243",32275,0.3,1400000,140,617419
"5244",9325,0.2,1120000,112,617531
"5245",42794,0.2,1460000,146,617677
"5246",9188,0.3,1500000,150,617827
"5247",31918,0.3,8e+05,80,617907
"5248",32193,0.3,7e+05,70,617977
"5249",32098,0.3,2360000,236,618213
"5250",42707,0.3,1700000,170,618383
"5251",42782,0.3,2800000,280,618663
"5252",9174,0.3,1700000,170,618833
"5253",31915,0.3,1400000,140,618973
"5254",9136,0.3,8e+05,80,619053
"5255",8951,0.3,7e+05,70,619123
"5256",8956,0.3,8e+05,80,619203
"5257",8950,0.3,7e+05,70,619273
"5258",31947,0.2,1500000,150,619423
"5259",9066,0.2,1830000,183,619606
"5260",9314,0.3,3300000,330,619936
"5261",31879,0.3,640000,64,620000
"5262",31893,0.3,2e+06,200,620200
"5263",9122,0.2,1500000,150,620350
"5264",31736,0.3,8e+05,80,620430
"5265",31830,0.2,1260000,126,620556
"5266",9021,0.3,560000,56,620612
"5267",31802,0.3,1130000,113,620725
"5268",31842,0.3,1800000,180,620905
"5269",8935,0.2,1340000,134,621039
"5270",9132,0.2,3700000,370,621409
"5271",8829,0.3,8e+05,80,621489
"5272",42633,0.3,640000,64,621553
"5273",9086,0.3,7e+05,70,621623
"5274",31731,0.3,560000,56,621679
"5275",8911,0.3,560000,56,621735
"5276",31780,0.3,490000,49,621784
"5277",32051,0.2,1900000,190,621974
"5278",32054,0.3,1990000,199,622173
"5279",31658,0.3,490000,49,622222
"5280",31829,0.3,1200000,120,622342
"5281",8932,0.3,560000,56,622398
"5282",31751,0.3,560000,56,622454
"5283",8882,0.3,1500000,150,622604
"5284",8832,0.3,1050000,105,622709
"5285",31690,0.3,560000,56,622765
"5286",31904,0.3,1750000,175,622940
"5287",31886,0.3,1700000,170,623110
"5288",8931,0.3,8e+05,80,623190
"5289",31721,0.3,4390000,439,623629
"5290",31656,0.3,1560000,156,623785
"5291",8875,0.3,2e+06,200,623985
"5292",8998,0.3,7e+05,70,624055
"5293",42623,0.2,3190000,319,624374
"5294",8814,0.3,2200000,220,624594
"5295",8678,0.2,3900000,390,624984
"5296",42560,0.3,8e+05,80,625064
"5297",42611,0.2,2790000,279,625343
"5298",42715,0.2,4150000,415,625758
"5299",31528,0.3,8e+05,80,625838
"5300",8655,0.166666666666667,2940000,294,626132
"5301",23726,0.3,2260000,226,626358
"5302",23729,0.3,490000,49,626407
"5303",8861,0.3,490000,49,626456
"5304",42648,0.3,560000,56,626512
"5305",42627,0.233333333333333,2260000,226,626738
"5306",8811,0.3,490000,49,626787
"5307",42618,0.3,1360000,136,626923
"5308",31671,0.233333333333333,4360000,436,627359
"5309",31555,0.3,490000,49,627408
"5310",42554,0.3,1190000,119,627527
"5311",31467,0.3,2310000,231,627758
"5312",23715,0.3,8e+05,80,627838
"5313",21303,0.3,1190000,119,627957
"5314",42575,0.3,1800000,180,628137
"5315",9140,0.2,2680000,268,628405
"5316",31606,0.3,1990000,199,628604
"5317",31735,0.3,1890000,189,628793
"5318",8681,0.3,2550000,255,629048
"5319",42646,0.2,1500000,150,629198
"5320",42622,0.3,1190000,119,629317
"5321",42593,0.3,3760000,376,629693
"5322",8449,0.3,9e+05,90,629783
"5323",42453,0.3,8e+05,80,629863
"5324",31160,0.3,7e+05,70,629933
"5325",31188,0.3,7e+05,70,630003
"5326",8366,0.3,1e+06,100,630103
"5327",31182,0.3,8e+05,80,630183
"5328",8666,0.3,560000,56,630239
"5329",8706,0.3,1260000,126,630365
"5330",8580,0.3,490000,49,630414
"5331",31667,0.3,6240000,624,631038
"5334",8226,0.3,1340000,134,631172
"5335",8547,0.3,560000,56,631228
"5336",23703,0.2,1290000,129,631357
"5337",23717,0.3,2140000,214,631571
"5338",8586,0.3,560000,56,631627
"5339",31700,0.3,2140000,214,631841
"5340",31501,0.3,2450000,245,632086
"5341",31233,0.3,1430000,143,632229
"5342",31791,0.3,7150000,715,632944
"5343",31365,0.3,2060000,206,633150
"5344",8450,0.3,560000,56,633206
"5345",31256,0.3,8e+05,80,633286
"5346",8616,0.3,560000,56,633342
"5347",8282,0.3,640000,64,633406
"5348",31295,0.2,1290000,129,633535
"5349",8268,0.3,560000,56,633591
"5350",31058,0.3,640000,64,633655
"5351",8494,0.3,8e+05,80,633735
"5352",8135,0.3,640000,64,633799
"5353",8210,0.3,1280000,128,633927
"5354",23704,0.3,630000,63,633990
"5355",23690,0.3,9e+05,90,634080
"5356",23685,0.3,630000,63,634143
"5357",8296,0.3,9e+05,90,634233
"5358",8270,0.2,1520000,152,634385
"5359",8298,0.3,1350000,135,634520
"5360",31506,0.3,7050000,705,635225
"5361",31415,0.3,4470000,447,635672
"5362",31044,0.3,3290000,329,636001
"5363",8378,0.3,9e+05,90,636091
"5364",8202,0.3,720000,72,636163
"5365",8235,0.15,3790000,379,636542
"5366",8134,0.3,2360000,236,636778
"5367",8139,0.3,630000,63,636841
"5368",23693,0.3,2800000,280,637121
"5369",8303,0.3,1360000,136,637257
"5370",8179,0.3,1360000,136,637393
"5371",42419,0.3,8e+05,80,637473
"5372",8304,0.3,640000,64,637537
"5373",42435,0.3,3530000,353,637890
"5374",42417,0.3,560000,56,637946
"5375",42442,0.2,1200000,120,638066
"5376",31087,0.3,3700000,370,638436
"5377",42515,0.3,6100000,610,639046
"5378",30965,0.3,560000,56,639102
"5379",8475,0.3,640000,64,639166
"5380",8112,0.3,8e+05,80,639246
"5381",31028,0.3,2420000,242,639488
"5382",30977,0.2,1280000,128,639616
"5383",42373,0.3,560000,56,639672
"5384",8054,0.3,720000,72,639744
"5385",8332,0.3,2330000,233,639977
"5386",23676,0.3,720000,72,640049
"5387",8159,0.3,630000,63,640112
"5388",30996,0.3,1910000,191,640303
"5389",8084,0.3,720000,72,640375
"5390",8193,0.3,630000,63,640438
"5391",8245,0.3,3610000,361,640799
"5392",30964,0.3,5050000,505,641304
"5393",31075,0.166666666666667,3350000,335,641639
"5394",30704,0.166666666666667,2480000,248,641887
"5395",8047,0.3,1820000,182,642069
"5396",30874,0.3,9e+05,90,642159
"5397",8087,0.2,7790000,779,642938
"5398",7891,0.3,1530000,153,643091
"5399",30813,0.3,640000,64,643155
"5400",30819,0.3,3690000,369,643524
"5402",42359,0.3,1360000,136,643660
"5403",7857,0.3,560000,56,643716
"5404",42352,0.3,640000,64,643780
"5405",30953,0.3,3450000,345,644125
"5406",7819,0.3,1050000,105,644230
"5407",8050,0.3,640000,64,644294
"5408",30710,0.3,1700000,170,644464
"5409",8036,0.3,1490000,149,644613
"5410",30855,0.3,2060000,206,644819
"5411",8016,0.3,1350000,135,644954
"5412",30774,0.2,1120000,112,645066
"5413",7643,0.3,560000,56,645122
"5414",42339,0.3,1190000,119,645241
"5415",21244,0.3,4520000,452,645693
"5416",7670,0.3,490000,49,645742
"5417",42309,0.3,560000,56,645798
"5418",30545,0.3,490000,49,645847
"5419",30591,0.3,1260000,126,645973
"5420",30452,0.3,1260000,126,646099
"5421",30397,0.3,1190000,119,646218
"5422",30429,0.3,7e+05,70,646288
"5427",30546,0.3,8e+05,80,646368
"5428",30491,0.3,1e+06,100,646468
"5429",30424,0.3,7e+05,70,646538
"5430",7790,0.3,8e+05,80,646618
"5433",30232,0.3,1800000,180,646798
"5434",7363,0.3,7e+05,70,646868
"5435",30287,0.3,8e+05,80,646948
"5436",7600,0.3,3100000,310,647258
"5437",30079,0.2,2160000,216,647474
"5438",30115,0.3,1e+06,100,647574
"5439",30163,0.3,1500000,150,647724
"5440",42271,0.3,1500000,150,647874
"5444",7388,0.3,7e+05,70,647944
"5445",7404,0.3,7e+05,70,648014
"5446",30386,0.3,2330000,233,648247
"5447",30293,0.3,1890000,189,648436
"5448",31191,0.3,10190000,1019,649455
"5449",30468,0.3,4950000,495,649950
"5450",30174,0.3,490000,49,649999
"5451",30077,0.3,490000,49,650048
"5452",7655,0.3,7e+05,70,650118
"5453",30438,0.3,1610000,161,650279
"5454",30230,0.3,2890000,289,650568
"5455",7253,0.3,560000,56,650624
"5456",29855,0.3,1050000,105,650729
"5458",7208,0.3,1190000,119,650848
"5460",30178,0.3,7510000,751,651599
"5461",7656,0.3,1890000,189,651788
"5462",21177,0.3,1e+06,100,651888
"5463",21189,0.3,1850000,185,652073
"5464",30195,0.3,1360000,136,652209
"5465",29954,0.3,1500000,150,652359
"5466",29861,0.3,1e+06,100,652459
"5467",30153,0.2,7160000,716,653175
"5468",7127,0.3,1e+06,100,653275
"5469",29888,0.3,8e+05,80,653355
"5470",7056,0.3,8e+05,80,653435
"5471",7125,0.25,2860000,286,653721
"5472",29626,0.3,8e+05,80,653801
"5473",7051,0.2,2800000,280,654081
"5475",7122,0.3,1e+06,100,654181
"5476",7112,0.3,7e+05,70,654251
"5477",29579,0.3,1e+06,100,654351
"5478",29549,0.3,7e+05,70,654421
"5479",7336,0.3,560000,56,654477
"5480",42277,0.3,2550000,255,654732
"5481",42305,0.3,4200000,420,655152
"5482",42250,0.3,560000,56,655208
"5483",21166,0.3,490000,49,655257
"5484",21168,0.3,7e+05,70,655327
"5485",30100,0.3,2400000,240,655567
"5486",7610,0.3,490000,49,655616
"5487",7415,0.3,560000,56,655672
"5488",7068,0.3,1120000,112,655784
"5489",7036,0.3,490000,49,655833
"5490",7286,0.2,1460000,146,655979
"5491",6984,0.233333333333333,1850000,185,656164
"5492",29951,0.3,3450000,345,656509
"5493",7389,0.166666666666667,4540000,454,656963
"5494",29697,0.3,1050000,105,657068
"5495",29919,0.3,4740000,474,657542
"5496",6841,0.3,7e+05,70,657612
"5497",6741,0.3,490000,49,657661
"5498",42221,0.3,8e+05,80,657741
"5499",7121,0.3,1360000,136,657877
"5500",21160,0.3,560000,56,657933
"5501",30211,0.3,4690000,469,658402
"5502",29866,0.2,2200000,220,658622
"5503",6816,0.3,8e+05,80,658702
"5504",29815,0.3,1200000,120,658822
"5505",42232,0.3,1990000,199,659021
"5506",6975,0.3,1200000,120,659141
"5507",7035,0.3,8e+05,80,659221
"5508",29499,0.3,1360000,136,659357
"5509",29770,0.3,640000,64,659421
"5510",29613,0.3,1500000,150,659571
"5511",6916,0.3,1640000,164,659735
"5512",6746,0.3,8e+05,80,659815
"5513",29624,0.3,1350000,135,659950
"5514",29440,0.3,640000,64,660014
"5515",6989,0.3,560000,56,660070
"5516",6935,0.166666666666667,1920000,192,660262
"5517",6706,0.3,560000,56,660318
"5518",29784,0.3,3010000,301,660619
"5519",29421,0.3,640000,64,660683
"5520",6849,0.233333333333333,3e+06,300,660983
"5521",42194,0.3,1050000,105,661088
"5522",29374,0.3,640000,64,661152
"5523",29402,0.3,8e+05,80,661232
"5524",6685,0.3,560000,56,661288
"5525",6453,0.3,640000,64,661352
"5526",6845,0.25,3380000,338,661690
"5529",29989,0.3,6080000,608,662298
"5530",6660,0.3,1e+06,100,662398
"5531",42186,0.3,7e+05,70,662468
"5532",29693,0.2,3510000,351,662819
"5533",6640,0.3,1e+06,100,662919
"5534",6757,0.3,1400000,140,663059
"5535",29628,0.3,5520000,552,663611
"5536",29523,0.3,4500000,450,664061
"5537",29277,0.3,7e+05,70,664131
"5538",29645,0.2,1640000,164,664295
"5539",6472,0.3,8e+05,80,664375
"5540",42191,0.3,7e+05,70,664445
"5541",29320,0.3,7e+05,70,664515
"5542",29448,0.2,1600000,160,664675
"5543",29583,0.3,7e+05,70,664745
"5544",6383,0.3,7e+05,70,664815
"5545",29153,0.3,8e+05,80,664895
"5548",29316,0.3,7e+05,70,664965
"5549",6594,0.3,1430000,143,665108
"5550",42201,0.3,1190000,119,665227
"5551",29860,0.3,4350000,435,665662
"5552",29545,0.3,2260000,226,665888
"5553",6850,0.3,490000,49,665937
"5554",29584,0.3,2960000,296,666233
"5555",29279,0.3,490000,49,666282
"5556",6374,0.3,7e+05,70,666352
"5557",29144,0.3,490000,49,666401
"5558",44284,0.3,1050000,105,666506
"5559",44278,0.3,7e+05,70,666576
"5560",42121,0.3,490000,49,666625
"5561",6308,0.3,7e+05,70,666695
"5562",29193,0.3,560000,56,666751
"5563",42132,0.3,1360000,136,666887
"5564",6656,0.3,1700000,170,667057
"5565",6451,0.2,2160000,216,667273
"5568",29348,0.3,3850000,385,667658
"5569",6800,0.3,1260000,126,667784
"5570",29079,0.3,560000,56,667840
"5571",6289,0.3,560000,56,667896
"5572",42180,0.3,1820000,182,668078
"5573",42118,0.3,7e+05,70,668148
"5574",42122,0.3,490000,49,668197
"5575",42177,0.3,7e+05,70,668267
"5576",42129,0.3,1490000,149,668416
"5577",29070,0.3,1190000,119,668535
"5578",6283,0.3,2260000,226,668761
"5579",29137,0.3,7e+05,70,668831
"5580",29057,0.3,490000,49,668880
"5581",6215,0.3,490000,49,668929
"5582",6282,0.3,1400000,140,669069
"5583",44293,0.3,1050000,105,669174
"5584",6351,0.2,1260000,126,669300
"5585",29181,0.3,1120000,112,669412
"5586",42109,0.3,490000,49,669461
"5587",28971,0.3,490000,49,669510
"5588",42117,0.3,1260000,126,669636
"5589",6313,0.3,1890000,189,669825
"5590",29746,0.3,9700000,970,670795
"5591",29308,0.3,8e+05,80,670875
"5593",21097,0.3,7e+05,70,670945
"5594",29447,0.3,8e+05,80,671025
"5595",6439,0.2,1500000,150,671175
"5596",29139,0.3,8e+05,80,671255
"5597",28994,0.3,7e+05,70,671325
"5598",42115,0.3,1500000,150,671475
"5599",6233,0.3,1e+06,100,671575
"5600",6423,0.3,8e+05,80,671655
"5601",6304,0.3,7e+05,70,671725
"5602",28963,0.3,8e+05,80,671805
"5603",29052,0.3,7e+05,70,671875
"5604",29114,0.2,1560000,156,672031
"5605",6629,0.3,8e+05,80,672111
"5606",29368,0.2,6070000,607,672718
"5607",6263,0.3,1700000,170,672888
"5608",44294,0.3,5660000,566,673454
"5609",44259,0.3,1290000,129,673583
"5610",6088,0.3,7e+05,70,673653
"5611",28929,0.3,1e+06,100,673753
"5612",28903,0.3,8e+05,80,673833
"5613",42090,0.3,7e+05,70,673903
"5614",29093,0.3,1190000,119,674022
"5615",6222,0.3,1680000,168,674190
"5616",6162,0.3,1700000,170,674360
"5617",29038,0.3,1700000,170,674530
"5618",6700,0.3,2060000,206,674736
"5619",29453,0.233333333333333,4140000,414,675150
"5620",28965,0.3,7e+05,70,675220
"5621",29109,0.3,1360000,136,675356
"5622",42087,0.3,560000,56,675412
"5623",21079,0.3,1400000,140,675552
"5624",42176,0.3,1190000,119,675671
"5625",29034,0.3,4740000,474,676145
"5627",6188,0.3,1360000,136,676281
"5628",28890,0.3,490000,49,676330
"5629",6077,0.3,490000,49,676379
"5630",42061,0.3,490000,49,676428
"5631",42092,0.3,560000,56,676484
"5632",6071,0.3,490000,49,676533
"5633",42123,0.3,1360000,136,676669
"5634",6279,0.3,630000,63,676732
"5635",6343,0.166666666666667,1890000,189,676921
"5636",42136,0.3,1360000,136,677057
"5637",6286,0.233333333333333,1750000,175,677232
"5638",6058,0.3,7e+05,70,677302
"5639",28941,0.3,560000,56,677358
"5640",28914,0.2,1400000,140,677498
"5641",29503,0.3,10050000,1005,678503
"5642",28856,0.3,560000,56,678559
"5643",6138,0.3,3060000,306,678865
"5644",6129,0.3,1560000,156,679021
"5645",42138,0.3,6700000,670,679691
"5646",5980,0.2,1050000,105,679796
"5647",6099,0.3,8e+05,80,679876
"5648",28949,0.3,2500000,250,680126
"5649",6200,0.3,7e+05,70,680196
"5650",28872,0.3,7e+05,70,680266
"5651",28824,0.3,1e+06,100,680366
"5652",42058,0.3,2400000,240,680606
"5653",5908,0.3,1e+06,100,680706
"5654",6117,0.3,8e+05,80,680786
"5655",28845,0.3,1e+06,100,680886
"5656",28847,0.3,7e+05,70,680956
"5657",5907,0.3,1e+06,100,681056
"5658",28808,0.3,7e+05,70,681126
"5659",44240,0.3,8e+05,80,681206
"5661",42001,0.3,8e+05,80,681286
"5662",42044,0.2,3850000,385,681671
"5663",41958,0.3,7e+05,70,681741
"5664",5829,0.3,8e+05,80,681821
"5665",28921,0.3,640000,64,681885
"5666",28875,0.3,1800000,180,682065
"5667",21076,0.3,3160000,316,682381
"5668",21058,0.3,1440000,144,682525
"5669",6011,0.3,8e+05,80,682605
"5670",29016,0.3,5600000,560,683165
"5671",6038,0.3,560000,56,683221
"5672",5934,0.3,8e+05,80,683301
"5673",5851,0.3,560000,56,683357
"5674",28769,0.3,8e+05,80,683437
"5675",28867,0.3,640000,64,683501
"5676",5976,0.233333333333333,1850000,185,683686
"5677",28822,0.2,2140000,214,683900
"5678",28699,0.2,1120000,112,684012
"5679",44250,0.3,1800000,180,684192
"5680",5820,0.3,1440000,144,684336
"5681",41908,0.3,640000,64,684400
"5682",5727,0.233333333333333,1850000,185,684585
"5683",5723,0.3,3290000,329,684914
"5686",28761,0.3,7e+05,70,684984
"5687",28862,0.3,560000,56,685040
"5688",42002,0.3,1050000,105,685145
"5689",28802,0.3,1050000,105,685250
"5690",28520,0.3,7e+05,70,685320
"5691",41951,0.3,1500000,150,685470
"5692",28495,0.3,7e+05,70,685540
"5693",28485,0.3,560000,56,685596
"5694",44248,0.3,2460000,246,685842
"5695",29554,0.2,12080000,1208,687050
"5697",41737,0.3,1260000,126,687176
"5698",41812,0.233333333333333,2130000,213,687389
"5699",28489,0.3,1260000,126,687515
"5700",28818,0.3,4600000,460,687975
"5701",5751,0.15,2980000,298,688273
"5702",6596,0.2,4900000,490,688763
"5703",28743,0.3,1360000,136,688899
"5704",28835,0.3,2450000,245,689144
"5705",28860,0.3,4550000,455,689599
"5706",28946,0.3,5300000,530,690129
"5707",28414,0.3,7e+05,70,690199
"5708",28639,0.3,7e+05,70,690269
"5709",5547,0.3,8e+05,80,690349
"5710",5759,0.2,1400000,140,690489
"5711",41684,0.3,1700000,170,690659
"5712",44230,0.3,1700000,170,690829
"5713",5556,0.3,8e+05,80,690909
"5716",5609,0.3,8e+05,80,690989
"5717",5725,0.3,7e+05,70,691059
"5718",41893,0.3,3550000,355,691414
"5719",5809,0.3,490000,49,691463
"5720",5560,0.3,490000,49,691512
"5721",5819,0.3,4110000,411,691923
"5722",28422,0.3,1190000,119,692042
"5723",28446,0.3,2060000,206,692248
"5724",41623,0.3,1050000,105,692353
"5725",41675,0.3,1050000,105,692458
"5726",5558,0.3,490000,49,692507
"5727",41887,0.3,2360000,236,692743
"5728",5797,0.3,7e+05,70,692813
"5729",41588,0.3,1850000,185,692998
"5730",5485,0.3,1190000,119,693117
"5731",28284,0.3,560000,56,693173
"5732",5428,0.3,1390000,139,693312
"5733",5360,0.3,7e+05,70,693382
"5734",28356,0.3,1e+06,100,693482
"5735",6079,0.3,8e+05,80,693562
"5736",41569,0.3,7e+05,70,693632
"5737",28354,0.3,1360000,136,693768
"5738",5465,0.3,1e+06,100,693868
"5739",28305,0.3,1500000,150,694018
"5740",28304,0.3,1700000,170,694188
"5741",28479,0.3,1360000,136,694324
"5742",21002,0.3,8e+05,80,694404
"5743",5453,0.3,7e+05,70,694474
"5744",5308,0.3,1500000,150,694624
"5745",28221,0.3,8e+05,80,694704
"5746",5594,0.3,1190000,119,694823
"5747",28251,0.3,560000,56,694879
"5748",41508,0.3,1190000,119,694998
"5749",41665,0.3,2060000,206,695204
"5750",5347,0.3,560000,56,695260
"5751",28611,0.3,12790000,1279,696539
"5752",5391,0.3,560000,56,696595
"5753",28254,0.3,1190000,119,696714
"5754",5451,0.3,1750000,175,696889
"5755",28233,0.3,560000,56,696945
"5756",28229,0.3,630000,63,697008
"5757",20986,0.3,1050000,105,697113
"5758",5524,0.3,2960000,296,697409
"5759",41862,0.3,8500000,850,698259
"5760",28076,0.3,490000,49,698308
"5761",5129,0.3,7e+05,70,698378
"5762",41296,0.3,490000,49,698427
"5763",28419,0.3,7380000,738,699165
"5764",5450,0.3,640000,64,699229
"5765",5659,0.3,640000,64,699293
"5766",28175,0.3,8e+05,80,699373
"5767",28864,0.3,17630000,1763,701136
"5768",28203,0.3,560000,56,701192
"5769",5283,0.233333333333333,3600000,360,701552
"5770",28157,0.3,8e+05,80,701632
"5771",28171,0.3,640000,64,701696
"5772",28101,0.3,8e+05,80,701776
"5774",41691,0.166666666666667,2960000,296,702072
"5775",41583,0.3,4780000,478,702550
"5776",41680,0.3,7310000,731,703281
"5777",5439,0.3,9e+05,90,703371
"5778",28062,0.3,720000,72,703443
"5779",28112,0.3,9e+05,90,703533
"5780",28086,0.3,9e+05,90,703623
"5781",5282,0.166666666666667,2620000,262,703885
"5782",41289,0.3,1530000,153,704038
"5783",27993,0.3,720000,72,704110
"5784",5067,0.3,9e+05,90,704200
"5785",5085,0.3,1280000,128,704328
"5786",5122,0.3,1200000,120,704448
"5787",5637,0.2,7430000,743,705191
"5789",27950,0.3,640000,64,705255
"5790",28295,0.3,8e+06,800,706055
"5791",28041,0.3,8e+05,80,706135
"5792",5114,0.3,8e+05,80,706215
"5793",27956,0.3,3530000,353,706568
"5794",28035,0.3,4810000,481,707049
"5795",41138,0.3,1440000,144,707193
"5796",28465,0.15,3180000,318,707511
"5797",28205,0.2,2400000,240,707751
"5798",41239,0.3,560000,56,707807
"5799",5170,0.3,630000,63,707870
"5800",41337,0.3,1050000,105,707975
"5801",4916,0.3,490000,49,708024
"5802",4746,0.3,1890000,189,708213
"5803",5149,0.2,1690000,169,708382
"5804",41208,0.3,1360000,136,708518
"5805",27916,0.2,5160000,516,709034
"5806",41011,0.3,1e+06,100,709134
"5807",4925,0.3,7e+05,70,709204
"5808",41450,0.2,7410000,741,709945
"5809",41041,0.3,560000,56,710001
"5810",27856,0.3,1700000,170,710171
"5811",5046,0.3,560000,56,710227
"5812",4622,0.2,1920000,192,710419
"5813",40900,0.3,560000,56,710475
"5814",4633,0.3,9e+05,90,710565
"5815",40935,0.3,8e+05,80,710645
"5816",27538,0.3,7e+05,70,710715
"5817",27276,0.3,1e+06,100,710815
"5818",4538,0.3,8e+05,80,710895
"5819",41237,0.2,5440000,544,711439
"5820",27246,0.3,7e+05,70,711509
"5821",4530,0.3,490000,49,711558
"5822",40895,0.3,490000,49,711607
"5823",4432,0.3,560000,56,711663
"5824",40908,0.3,490000,49,711712
"5825",4459,0.3,560000,56,711768
"5826",27286,0.3,1190000,119,711887
"5827",4455,0.3,7e+05,70,711957
"5828",27179,0.3,560000,56,712013
"5832",40982,0.2,5510000,551,712564
"5833",41146,0.3,6440000,644,713208
"5834",41016,0.2,2830000,283,713491
"5835",27143,0.3,640000,64,713555
"5836",4276,0.3,8e+05,80,713635
"5837",40892,0.3,2140000,214,713849
"5838",40942,0.3,8e+05,80,713929
"5839",27189,0.3,640000,64,713993
"5840",4249,0.3,640000,64,714057
"5841",27062,0.3,1260000,126,714183
"5842",4184,0.3,8e+05,80,714263
"5843",40926,0.3,3460000,346,714609
"5844",40835,0.3,8e+05,80,714689
"5845",26995,0.3,8e+05,80,714769
"5846",27124,0.3,1900000,190,714959
"5847",26998,0.3,7e+05,70,715029
"5848",27024,0.3,7e+05,70,715099
"5849",4208,0.3,8e+05,80,715179
"5850",4515,0.3,2260000,226,715405
"5851",40805,0.3,8e+05,80,715485
"5852",40796,0.3,1e+06,100,715585
"5853",26953,0.3,8e+05,80,715665
"5854",27001,0.3,7e+05,70,715735
"5855",27044,0.3,1e+06,100,715835
"5856",27006,0.3,8e+05,80,715915
"5857",4267,0.3,7e+05,70,715985
"5858",40816,0.3,560000,56,716041
"5859",40781,0.3,1190000,119,716160
"5860",27202,0.3,1050000,105,716265
"5861",40852,0.3,5890000,589,716854
"5862",26907,0.3,490000,49,716903
"5863",4144,0.3,490000,49,716952
"5864",26938,0.3,560000,56,717008
"5865",26977,0.3,490000,49,717057
"5866",40737,0.3,2500000,250,717307
"5867",27104,0.3,2500000,250,717557
"5868",3925,0.3,7e+05,70,717627
"5869",26798,0.3,7e+05,70,717697
"5870",26991,0.3,8e+05,80,717777
"5871",27002,0.3,3590000,359,718136
"5872",26815,0.3,8e+05,80,718216
"5873",40707,0.2,1120000,112,718328
"5874",40709,0.2,2190000,219,718547
"5875",40774,0.2,6880000,688,719235
"5876",3958,0.2,1260000,126,719361
"5877",26811,0.3,490000,49,719410
"5878",26760,0.3,560000,56,719466
"5879",3741,0.3,1700000,170,719636
"5880",27303,0.3,1.3e+07,1300,720936
"5881",26859,0.3,4040000,404,721340
"5882",20173,0.3,490000,49,721389
"5883",20153,0.3,1260000,126,721515
"5884",3429,0.3,490000,49,721564
"5885",26774,0.3,1400000,140,721704
"5886",26898,0.3,2960000,296,722000
"5887",26942,0.3,7350000,735,722735
"5888",26613,0.3,7e+05,70,722805
"5889",26658,0.3,1260000,126,722931
"5890",26639,0.3,560000,56,722987
"5891",3436,0.3,7e+05,70,723057
"5892",20128,0.3,8e+05,80,723137
"5893",26595,0.3,1e+06,100,723237
"5894",26813,0.3,1680000,168,723405
"5895",3299,0.3,8e+05,80,723485
"5896",26588,0.3,1e+06,100,723585
"5897",26637,0.3,2190000,219,723804
"5898",3249,0.3,1500000,150,723954
"5899",27171,0.2,8010000,801,724755
"5900",3296,0.3,1e+06,100,724855
"5901",26522,0.3,8e+05,80,724935
"5902",20006,0.3,2600000,260,725195
"5903",3200,0.3,1440000,144,725339
"5904",3257,0.3,560000,56,725395
"5905",3437,0.3,8e+05,80,725475
"5906",19748,0.3,8e+05,80,725555
"5908",19815,0.3,630000,63,725618
"5909",26521,0.2,1540000,154,725772
"5910",3211,0.3,630000,63,725835
"5911",26593,0.3,5050000,505,726340
"5912",40624,0.3,1460000,146,726486
"5913",26491,0.3,3530000,353,726839
"5914",26636,0.3,3180000,318,727157
"5915",2932,0.3,8e+05,80,727237
"5916",3004,0.3,560000,56,727293
"5917",26440,0.3,720000,72,727365
"5918",26468,0.3,1500000,150,727515
"5919",22825,0.3,490000,49,727564
"5920",26352,0.3,560000,56,727620
"5921",40566,0.3,1990000,199,727819
"5922",2880,0.3,1500000,150,727969
"5923",26373,0.3,2750000,275,728244
"5924",2989,0.2,1340000,134,728378
"5925",22873,0.3,2760000,276,728654
"5926",26519,0.2,4420000,442,729096
"5927",40645,0.3,7690000,769,729865
"5928",40580,0.3,5300000,530,730395
"5929",26285,0.3,490000,49,730444
"5930",22749,0.3,1050000,105,730549
"5931",22772,0.3,1700000,170,730719
"5932",19558,0.3,560000,56,730775
"5933",2691,0.3,640000,64,730839
"5934",40514,0.3,2660000,266,731105
"5935",40527,0.3,560000,56,731161
"5938",22709,0.3,640000,64,731225
"5939",40697,0.3,20040000,2004,733229
"5940",40447,0.3,9e+05,90,733319
"5941",40526,0.3,3350000,335,733654
"5942",2519,0.3,630000,63,733717
"5943",2553,0.3,630000,63,733780
"5944",40475,0.3,1280000,128,733908
"5945",40503,0.3,2260000,226,734134
"5946",40446,0.3,1350000,135,734269
"5948",40513,0.3,3190000,319,734588
"5949",40384,0.3,1200000,120,734708
"5950",40437,0.3,8e+05,80,734788
"5951",22576,0.3,560000,56,734844
"5952",26295,0.3,4050000,405,735249
"5953",2409,0.233333333333333,2550000,255,735504
"5954",40416,0.3,1440000,144,735648
"5955",40344,0.3,1800000,180,735828
"5956",26214,0.3,3100000,310,736138
"5957",2230,0.3,1500000,150,736288
"5958",19243,0.3,8e+05,80,736368
"5960",26201,0.3,1190000,119,736487
"5962",40407,0.233333333333333,5950000,595,737082
"5963",26196,0.3,1190000,119,737201
"5964",40277,0.3,560000,56,737257
"5965",26165,0.3,7e+05,70,737327
"5969",26222,0.3,3380000,338,737665
"5970",2417,0.2,1490000,149,737814
"5971",26154,0.2,1850000,185,737999
"5972",26290,0.3,9200000,920,738919
"5973",40236,0.3,7e+05,70,738989
"5974",26197,0.3,2400000,240,739229
"5975",40262,0.2,1890000,189,739418
"5976",40254,0.3,490000,49,739467
"5977",40305,0.3,2520000,252,739719
"5978",26128,0.3,8e+05,80,739799
"5979",40199,0.3,1990000,199,739998
"5980",40177,0.3,8e+05,80,740078
"5981",2038,0.3,1e+06,100,740178
"5982",40189,0.3,8e+05,80,740258
"5983",40196,0.3,1e+06,100,740358
"5984",40172,0.3,7e+05,70,740428
"5985",2034,0.3,1360000,136,740564
"5986",2086,0.3,1700000,170,740734
"5988",26167,0.3,4150000,415,741149
"5989",40175,0.2,2750000,275,741424
"5990",40152,0.3,560000,56,741480
"5991",40146,0.3,7e+05,70,741550
"5992",40141,0.3,560000,56,741606
"5993",40143,0.3,1190000,119,741725
"5994",1947,0.3,560000,56,741781
"5995",1987,0.3,2290000,229,742010
"5996",40192,0.3,2850000,285,742295
"5997",40104,0.3,7e+05,70,742365
"5998",1914,0.3,1e+06,100,742465
"5999",40129,0.3,1e+06,100,742565
"6000",40123,0.3,7e+05,70,742635
"6001",26070,0.3,8e+05,80,742715
"6002",26089,0.3,1750000,175,742890
"6003",26073,0.3,4250000,425,743315
"6004",1875,0.3,7e+05,70,743385
"6006",1991,0.3,8e+05,80,743465
"6007",40088,0.3,560000,56,743521
"6008",40127,0.3,1440000,144,743665
"6009",40119,0.3,2e+06,200,743865
"6010",26017,0.3,1130000,113,743978
"6011",1891,0.3,560000,56,744034
"6012",1843,0.3,8e+05,80,744114
"6013",25956,0.3,640000,64,744178
"6014",25960,0.3,1920000,192,744370
"6015",1818,0.3,1340000,134,744504
"6016",1832,0.3,560000,56,744560
"6017",26055,0.3,2600000,260,744820
"6018",26040,0.3,1260000,126,744946
"6019",44201,0.3,1800000,180,745126
"6020",1854,0.3,8e+05,80,745206
"6021",1848,0.3,560000,56,745262
"6022",40048,0.3,640000,64,745326
"6023",40050,0.3,560000,56,745382
"6024",40145,0.3,4750000,475,745857
"6025",40144,0.3,7e+05,70,745927
"6026",1844,0.3,490000,49,745976
"6027",40034,0.3,7e+05,70,746046
"6028",25951,0.3,560000,56,746102
"6029",1925,0.3,1900000,190,746292
"6030",25886,0.3,490000,49,746341
"6031",40006,0.3,490000,49,746390
"6032",22283,0.3,7e+05,70,746460
"6033",22419,0.3,9140000,914,747374
"6034",1782,0.3,7e+05,70,747444
"6035",25923,0.3,1e+06,100,747544
"6036",25914,0.2,1260000,126,747670
"6037",25889,0.3,8e+05,80,747750
"6038",1716,0.3,7e+05,70,747820
"6039",40025,0.3,8e+05,80,747900
"6040",25973,0.3,1800000,180,748080
"6041",25976,0.3,1700000,170,748250
"6042",1682,0.3,7e+05,70,748320
"6043",39985,0.3,490000,49,748369
"6044",40036,0.3,3060000,306,748675
"6045",1704,0.3,7e+05,70,748745
"6046",39959,0.3,490000,49,748794
"6049",40002,0.3,2480000,248,749042
"6050",25799,0.3,560000,56,749098
"6051",1666,0.3,490000,49,749147
"6052",1686,0.2,1050000,105,749252
"6053",39936,0.3,7e+05,70,749322
"6054",25962,0.3,2060000,206,749528
"6055",25834,0.3,1360000,136,749664
"6056",25853,0.2,1490000,149,749813
"6057",39923,0.3,1800000,180,749993
"6058",25867,0.3,7e+05,70,750063
"6059",25717,0.3,8e+05,80,750143
"6060",25759,0.3,7e+05,70,750213
"6061",25579,0.3,7e+05,70,750283
"6062",25703,0.3,1e+06,100,750383
"6063",25749,0.3,1700000,170,750553
"6064",25912,0.3,10390000,1039,751592
"6065",25608,0.3,560000,56,751648
"6066",25760,0.3,1890000,189,751837
"6067",25635,0.3,7e+05,70,751907
"6068",25546,0.3,490000,49,751956
"6069",25814,0.2,1560000,156,752112
"6070",25516,0.3,7e+05,70,752182
"6071",25532,0.3,560000,56,752238
"6072",25612,0.3,490000,49,752287
"6073",1528,0.3,7e+05,70,752357
"6074",25629,0.3,2490000,249,752606
"6075",1448,0.3,560000,56,752662
"6076",25562,0.3,640000,64,752726
"6077",25436,0.3,8e+05,80,752806
"6078",25722,0.3,3560000,356,753162
"6079",25438,0.3,8e+05,80,753242
"6080",1462,0.3,560000,56,753298
"6081",25405,0.3,1440000,144,753442
"6082",25415,0.3,560000,56,753498
"6083",25482,0.3,1440000,144,753642
"6084",25409,0.3,720000,72,753714
"6085",1515,0.3,560000,56,753770
"6088",23656,0.3,1990000,199,753969
"6089",23640,0.3,1700000,170,754139
"6090",1444,0.3,630000,63,754202
"6091",1414,0.3,720000,72,754274
"6092",25297,0.3,9e+05,90,754364
"6094",1438,0.3,720000,72,754436
"6095",25251,0.3,1530000,153,754589
"6096",25550,0.3,2410000,241,754830
"6097",25296,0.3,810000,81,754911
"6098",25218,0.3,720000,72,754983
"6099",25428,0.3,3060000,306,755289
"6100",25278,0.3,630000,63,755352
"6102",23565,0.3,560000,56,755408
"6103",23538,0.3,8e+05,80,755488
"6104",25124,0.3,720000,72,755560
"6105",1422,0.3,560000,56,755616
"6106",25136,0.3,640000,64,755680
"6107",1304,0.3,560000,56,755736
"6108",23501,0.3,7e+05,70,755806
"6109",25097,0.3,490000,49,755855
"6110",25094,0.3,7e+05,70,755925
"6111",25168,0.3,3050000,305,756230
"6112",25442,0.3,4980000,498,756728
"6113",1206,0.3,560000,56,756784
"6114",24981,0.3,1e+06,100,756884
"6119",24975,0.3,7e+05,70,756954
"6120",1310,0.3,8e+05,80,757034
"6121",24997,0.3,1e+06,100,757134
"6122",1211,0.233333333333333,2160000,216,757350
"6124",1146,0.3,8e+05,80,757430
"6127",24916,0.2,1700000,170,757600
"6129",25015,0.3,3060000,306,757906
"6130",24943,0.3,1260000,126,758032
"6131",24821,0.3,490000,49,758081
"6132",25041,0.3,1890000,189,758270
"6134",39652,0.3,7e+05,70,758340
"6135",39681,0.3,560000,56,758396
"6136",25361,0.3,2890000,289,758685
"6137",24958,0.3,560000,56,758741
"6138",24952,0.3,2190000,219,758960
"6140",24796,0.3,1700000,170,759130
"6141",24740,0.3,1e+06,100,759230
"6142",980,0.3,2850000,285,759515
"6143",39617,0.3,1190000,119,759634
"6144",24683,0.3,1700000,170,759804
"6145",24725,0.3,490000,49,759853
"6146",1018,0.3,490000,49,759902
"6147",936,0.3,560000,56,759958
"6148",1372,0.3,8e+05,80,760038
"6149",39491,0.2,2080000,208,760246
"6150",24378,0.3,8e+05,80,760326
"6151",39629,0.3,640000,64,760390
"6152",24392,0.3,560000,56,760446
"6153",39479,0.3,630000,63,760509
"6154",39535,0.3,1700000,170,760679
"6155",39796,0.3,1990000,199,760878
"6156",24534,0.2,1330000,133,761011
"6157",777,0.3,810000,81,761092
"6158",39376,0.3,720000,72,761164
"6159",1013,0.3,9e+05,90,761254
"6160",24321,0.3,630000,63,761317
"6161",39416,0.3,1350000,135,761452
"6162",829,0.233333333333333,2650000,265,761717
"6163",39222,0.3,720000,72,761789
"6164",24531,0.3,5270000,527,762316
"6165",24348,0.3,2090000,209,762525
"6166",39399,0.3,560000,56,762581
"6167",39351,0.3,1260000,126,762707
"6168",24375,0.3,3680000,368,763075
"6169",751,0.2,1560000,156,763231
"6170",39162,0.3,1700000,170,763401
"6171",769,0.3,1260000,126,763527
"6172",24288,0.2,2200000,220,763747
"6173",684,0.3,1e+06,100,763847
"6174",726,0.3,2e+06,200,764047
"6175",735,0.3,3300000,330,764377
"6176",648,0.3,8e+05,80,764457
"6177",650,0.3,560000,56,764513
"6178",39044,0.3,1190000,119,764632
"6179",39108,0.3,560000,56,764688
"6180",24242,0.3,490000,49,764737
"6181",24299,0.3,3760000,376,765113
"6182",725,0.3,560000,56,765169
"6183",671,0.3,7e+05,70,765239
"6184",635,0.3,560000,56,765295
"6185",38965,0.3,490000,49,765344
"6186",38996,0.3,7e+05,70,765414
"6187",38997,0.3,560000,56,765470
"6188",24238,0.3,560000,56,765526
"6189",592,0.3,7e+05,70,765596
"6190",584,0.233333333333333,1990000,199,765795
"6191",24257,0.3,490000,49,765844
"6192",38962,0.3,560000,56,765900
"6193",38948,0.2,1430000,143,766043
"6194",24225,0.3,7e+05,70,766113
"6195",576,0.3,1490000,149,766262
"6196",24205,0.3,1260000,126,766388
"6197",589,0.3,1e+06,100,766488
"6198",24213,0.3,8e+05,80,766568
"6201",24231,0.3,7e+05,70,766638
"6202",39086,0.2,4230000,423,767061
"6203",520,0.3,490000,49,767110
"6204",24157,0.3,2260000,226,767336
"6205",24207,0.3,7e+05,70,767406
"6206",38967,0.3,1700000,170,767576
"6208",508,0.3,8e+05,80,767656
"6210",433,0.3,560000,56,767712
"6211",24133,0.3,8e+05,80,767792
"6212",38922,0.3,1200000,120,767912
"6213",38853,0.3,2160000,216,768128
"6214",24111,0.3,640000,64,768192
"6215",24106,0.3,1340000,134,768326
"6216",462,0.3,8e+05,80,768406
"6217",474,0.3,1e+06,100,768506
"6218",410,0.2,1820000,182,768688
"6219",24102,0.3,8e+05,80,768768
"6220",413,0.3,1500000,150,768918
"6221",38718,0.3,1260000,126,769044
"6222",38736,0.3,1190000,119,769163
"6223",38797,0.3,490000,49,769212
"6224",342,0.3,560000,56,769268
"6225",23985,0.3,1e+06,100,769368
"6226",270,0.2,1990000,199,769567
"6227",23987,0.3,7e+05,70,769637
"6228",23971,0.3,1050000,105,769742
"6229",24051,0.3,2400000,240,769982
"6230",24000,0.3,1750000,175,770157
"6231",405,0.3,8740000,874,771031
"6233",38351,0.1,7e+05,70,771101
"6234",18986,0.1,1e+06,100,771201
"6235",18887,0.1,7e+05,70,771271
"6236",18909,0.1,1e+06,100,771371
"6238",18930,0.1,1500000,150,771521
"6239",18951,0.1,1700000,170,771691
"6240",18879,0.1,1800000,180,771871
"6241",38298,0.1,7e+05,70,771941
"6242",18868,0.1,8e+05,80,772021
"6243",38322,0.1,8e+05,80,772101
"6244",44158,0.1,560000,56,772157
"6245",18841,0.1,1050000,105,772262
"6246",18792,0.1,1190000,119,772381
"6247",38282,0.1,1050000,105,772486
"6248",18797,0.1,1190000,119,772605
"6249",38304,0.1,2400000,240,772845
"6250",38251,0.1,5210000,521,773366
"6252",18618,0.1,7e+05,70,773436
"6253",18640,0.1,1050000,105,773541
"6255",18629,0.1,560000,56,773597
"6256",18680,0.1,1190000,119,773716
"6257",18585,0.1,1700000,170,773886
"6258",18608,0.1,8e+05,80,773966
"6259",18767,0.1,4010000,401,774367
"6260",18604,0.1,1500000,150,774517
"6261",18548,0.1,7e+05,70,774587
"6262",18529,0.1,8e+05,80,774667
"6263",38073,0.1,640000,64,774731
"6264",18507,0.1,1360000,136,774867
"6265",18385,0.1,640000,64,774931
"6266",18577,0.1,1800000,180,775111
"6267",18411,0.1,640000,64,775175
"6268",18601,0.1,720000,72,775247
"6269",18312,0.1,560000,56,775303
"6270",38125,0.1,1260000,126,775429
"6271",18396,0.1,1610000,161,775590
"6272",37904,0.1,630000,63,775653
"6273",18291,0.1,490000,49,775702
"6274",18494,0.1,3450000,345,776047
"6275",18269,0.1,2160000,216,776263
"6276",38004,0.1,8e+05,80,776343
"6277",18278,0.1,2010000,201,776544
"6278",37997,0.1,4740000,474,777018
"6279",37890,0.1,2360000,236,777254
"6280",18259,0.1,1500000,150,777404
"6281",37897,0.1,490000,49,777453
"6282",18164,0.1,3330000,333,777786
"6283",37901,0.1,4710000,471,778257
"6284",18303,0.1,7e+05,70,778327
"6285",18188,0.1,490000,49,778376
"6286",37742,0.1,1500000,150,778526
"6287",37744,0.1,9e+05,90,778616
"6288",37816,0.1,1e+06,100,778716
"6289",18019,0.1,1e+06,100,778816
"6290",18048,0.1,8e+05,80,778896
"6291",18075,0.1,1e+06,100,778996
"6292",37789,0.1,1990000,199,779195
"6293",17954,0.1,560000,56,779251
"6294",18082,0.1,630000,63,779314
"6295",18069,0.1,7e+05,70,779384
"6296",18023,0.1,4230000,423,779807
"6297",37817,0.1,5170000,517,780324
"6298",37693,0.1,1190000,119,780443
"6299",37542,0.1,7e+05,70,780513
"6300",37560,0.1,560000,56,780569
"6301",17913,0.1,1130000,113,780682
"6302",37717,0.1,3200000,320,781002
"6303",17799,0.1,560000,56,781058
"6304",37596,0.1,640000,64,781122
"6305",37527,0.1,720000,72,781194
"6306",37539,0.1,1200000,120,781314
"6307",17944,0.1,3050000,305,781619
"6308",37586,0.1,2220000,222,781841
"6309",37647,0.1,1690000,169,782010
"6310",37660,0.1,1900000,190,782200
"6311",37617,0.1,8e+05,80,782280
"6312",37656,0.1,3040000,304,782584
"6313",17733,0.1,640000,64,782648
"6314",37444,0.1,560000,56,782704
"6315",37475,0.1,8e+05,80,782784
"6316",17889,0.1,810000,81,782865
"6317",17827,0.1,2250000,225,783090
"6318",37365,0.1,720000,72,783162
"6319",18026,0.1,3470000,347,783509
"6320",17821,0.1,1530000,153,783662
"6321",37385,0.1,1190000,119,783781
"6322",37349,0.1,2600000,260,784041
"6323",17772,0.1,2330000,233,784274
"6324",17660,0.1,640000,64,784338
"6325",17615,0.1,1920000,192,784530
"6326",17822,0.1,640000,64,784594
"6327",37255,0.1,560000,56,784650
"6328",37481,0.1,3610000,361,785011
"6329",37413,0.1,2730000,273,785284
"6330",37317,0.1,8e+05,80,785364
"6331",17621,0.1,1200000,120,785484
"6332",37283,0.1,8e+05,80,785564
"6333",37229,0.1,8e+05,80,785644
"6334",17528,0.1,8e+05,80,785724
"6335",17762,0.1,1360000,136,785860
"6336",17731,0.1,560000,56,785916
"6337",17569,0.1,3690000,369,786285
"6338",17572,0.1,1800000,180,786465
"6339",37253,0.1,1990000,199,786664
"6340",37190,0.1,7e+05,70,786734
"6341",17624,0.1,1e+06,100,786834
"6342",17547,0.1,2750000,275,787109
"6343",17655,0.1,2850000,285,787394
"6344",37319,0.1,3400000,340,787734
"6345",17819,0.1,2e+06,200,787934
"6346",37237,0.1,1400000,140,788074
"6347",17556,0.1,2260000,226,788300
"6348",37302,0.1,8e+05,80,788380
"6349",17541,0.1,1e+06,100,788480
"6350",17457,0.1,560000,56,788536
"6351",37189,0.1,1890000,189,788725
"6352",17419,0.1,560000,56,788781
"6353",37149,0.1,490000,49,788830
"6354",17465,0.1,2060000,206,789036
"6355",37239,0.1,1190000,119,789155
"6356",37187,0.1,1190000,119,789274
"6357",37247,0.1,560000,56,789330
"6358",18161,0.1,560000,56,789386
"6359",37177,0.1,2060000,206,789592
"6360",37147,0.1,490000,49,789641
"6361",37154,0.1,630000,63,789704
"6362",17305,0.1,560000,56,789760
"6363",17325,0.1,1050000,105,789865
"6364",37095,0.1,1400000,140,790005
"6365",17320,0.1,1050000,105,790110
"6366",37194,0.1,7e+05,70,790180
"6367",37119,0.1,7e+05,70,790250
"6368",17369,0.1,490000,49,790299
"6369",17249,0.1,7e+05,70,790369
"6370",17304,0.1,490000,49,790418
"6371",17372,0.1,1120000,112,790530
"6372",17276,0.1,1890000,189,790719
"6373",17404,0.1,1490000,149,790868
"6374",37156,0.1,1890000,189,791057
"6375",17250,0.1,560000,56,791113
"6376",17626,0.1,2880000,288,791401
"6377",17434,0.1,7e+05,70,791471
"6378",17149,0.1,2720000,272,791743
"6379",17162,0.1,8e+05,80,791823
"6380",37066,0.1,1e+06,100,791923
"6381",37060,0.1,3850000,385,792308
"6382",37053,0.1,1800000,180,792488
"6383",17327,0.1,1360000,136,792624
"6384",17235,0.1,7e+05,70,792694
"6385",17206,0.1,1e+06,100,792794
"6386",37031,0.1,7e+05,70,792864
"6387",37082,0.1,1e+06,100,792964
"6388",17205,0.1,7e+05,70,793034
"6389",37044,0.1,8e+05,80,793114
"6390",17088,0.1,7e+05,70,793184
"6391",36995,0.1,1e+06,100,793284
"6392",37091,0.1,8220000,822,794106
"6393",17153,0.1,2580000,258,794364
"6394",37032,0.1,1050000,105,794469
"6395",17169,0.1,2400000,240,794709
"6396",17087,0.1,560000,56,794765
"6397",37083,0.1,2190000,219,794984
"6398",17277,0.1,1360000,136,795120
"6399",17262,0.1,1190000,119,795239
"6400",37075,0.1,7e+05,70,795309
"6401",17224,0.1,3150000,315,795624
"6402",37061,0.1,490000,49,795673
"6403",17026,0.1,490000,49,795722
"6404",17039,0.1,8e+05,80,795802
"6405",16962,0.1,1200000,120,795922
"6406",16938,0.1,640000,64,795986
"6407",36940,0.1,560000,56,796042
"6408",36970,0.1,640000,64,796106
"6409",36969,0.1,1360000,136,796242
"6410",16963,0.1,560000,56,796298
"6411",17147,0.1,3910000,391,796689
"6412",16987,0.1,640000,64,796753
"6413",36949,0.1,8e+05,80,796833
"6414",37015,0.1,1200000,120,796953
"6415",36960,0.1,1440000,144,797097
"6416",16946,0.1,3140000,314,797411
"6417",36908,0.1,1290000,129,797540
"6418",36926,0.1,8e+05,80,797620
"6419",36953,0.1,8e+05,80,797700
"6420",36928,0.1,7e+05,70,797770
"6421",16920,0.1,2600000,260,798030
"6422",36935,0.1,2360000,236,798266
"6423",16801,0.1,7e+05,70,798336
"6424",16836,0.1,1700000,170,798506
"6425",36932,0.1,1e+06,100,798606
"6426",36894,0.1,4600000,460,799066
"6427",16989,0.1,5610000,561,799627
"6428",36847,0.1,7e+05,70,799697
"6429",16790,0.1,560000,56,799753
"6430",16863,0.1,1050000,105,799858
"6431",16889,0.1,1700000,170,800028
"6432",16783,0.1,1190000,119,800147
"6433",36931,0.1,560000,56,800203
"6434",16893,0.1,3130000,313,800516
"6435",16930,0.1,1190000,119,800635
"6436",16912,0.1,7e+05,70,800705
"6437",17013,0.1,1990000,199,800904
"6438",17011,0.1,1700000,170,801074
"6439",36872,0.1,490000,49,801123
"6440",36850,0.1,7e+05,70,801193
"6441",16687,0.1,490000,49,801242
"6443",36837,0.1,8e+05,80,801322
"6444",16625,0.1,1e+06,100,801422
"6445",36826,0.1,7e+05,70,801492
"6446",16575,0.1,8e+05,80,801572
"6447",16531,0.1,1e+06,100,801672
"6448",16467,0.1,3150000,315,801987
"6449",16534,0.1,1700000,170,802157
"6450",16567,0.1,1e+06,100,802257
"6451",36820,0.1,7e+05,70,802327
"6452",16882,0.1,9e+05,90,802417
"6453",16748,0.1,1360000,136,802553
"6454",16697,0.1,4250000,425,802978
"6455",36828,0.1,7e+05,70,803048
"6456",16547,0.1,1e+06,100,803148
"6457",36816,0.1,1e+06,100,803248
"6458",36809,0.1,8e+05,80,803328
"6459",17204,0.1,2700000,270,803598
"6460",17158,0.1,4060000,406,804004
"6461",16439,0.1,1260000,126,804130
"6462",16894,0.1,3060000,306,804436
"6463",16044,0.1,8e+05,80,804516
"6464",36797,0.1,2500000,250,804766
"6465",16295,0.1,490000,49,804815
"6466",36804,0.1,490000,49,804864
"6467",36802,0.1,560000,56,804920
"6468",16203,0.1,7e+05,70,804990
"6469",16564,0.1,490000,49,805039
"6470",16237,0.1,560000,56,805095
"6471",36760,0.1,560000,56,805151
"6472",16596,0.1,1050000,105,805256
"6473",36768,0.1,7e+05,70,805326
"6474",36818,0.1,1360000,136,805462
"6475",16536,0.1,1190000,119,805581
"6476",16496,0.1,1750000,175,805756
"6477",36774,0.1,7e+05,70,805826
"6478",36799,0.1,1050000,105,805931
"6479",16416,0.1,1700000,170,806101
"6480",36814,0.1,1990000,199,806300
"6481",36751,0.1,1190000,119,806419
"6482",16428,0.1,4170000,417,806836
"6483",36745,0.1,2460000,246,807082
"6484",16572,0.1,2900000,290,807372
"6485",36825,0.1,7e+05,70,807442
"6486",15997,0.1,490000,49,807491
"6487",16006,0.1,1460000,146,807637
"6488",36689,0.1,490000,49,807686
"6489",36759,0.1,7e+05,70,807756
"6490",16533,0.1,1120000,112,807868
"6491",16108,0.1,2450000,245,808113
"6492",36753,0.1,560000,56,808169
"6493",15967,0.1,7e+05,70,808239
"6494",36694,0.1,7e+05,70,808309
"6495",16084,0.1,1800000,180,808489
"6496",36684,0.1,1700000,170,808659
"6497",15860,0.1,8e+05,80,808739
"6498",16159,0.1,2620000,262,809001
"6499",36763,0.1,3690000,369,809370
"6500",15908,0.1,1990000,199,809569
"6501",16157,0.1,2190000,219,809788
"6502",15778,0.1,1600000,160,809948
"6503",15854,0.1,1910000,191,810139
"6504",36666,0.1,1640000,164,810303
"6505",15926,0.1,8e+05,80,810383
"6506",15646,0.1,640000,64,810447
"6507",15882,0.1,1800000,180,810627
"6508",36676,0.1,560000,56,810683
"6509",36548,0.1,560000,56,810739
"6510",36552,0.1,8e+05,80,810819
"6511",15448,0.1,560000,56,810875
"6512",36486,0.1,8e+05,80,810955
"6513",15950,0.1,2620000,262,811217
"6514",36491,0.1,560000,56,811273
"6515",36595,0.1,1190000,119,811392
"6516",36488,0.1,9e+05,90,811482
"6518",23854,0.1,720000,72,811554
"6519",15479,0.1,9e+05,90,811644
"6520",36456,0.1,630000,63,811707
"6521",36444,0.1,630000,63,811770
"6522",15357,0.1,560000,56,811826
"6523",15495,0.1,1990000,199,812025
"6524",15454,0.1,2060000,206,812231
"6526",23872,0.1,1260000,126,812357
"6527",23858,0.1,2260000,226,812583
"6528",15509,0.1,640000,64,812647
"6529",15407,0.1,2360000,236,812883
"6530",15445,0.1,2790000,279,813162
"6531",15944,0.1,2500000,250,813412
"6532",36729,0.1,8750000,875,814287
"6533",36367,0.1,560000,56,814343
"6534",36495,0.1,1200000,120,814463
"6535",15383,0.1,490000,49,814512
"6536",15428,0.1,1200000,120,814632
"6537",15429,0.1,2150000,215,814847
"6538",15513,0.1,3660000,366,815213
"6539",23855,0.1,1050000,105,815318
"6540",23851,0.1,560000,56,815374
"6541",15307,0.1,490000,49,815423
"6542",36408,0.1,560000,56,815479
"6543",15981,0.1,6500000,650,816129
"6544",15077,0.1,8e+05,80,816209
"6545",15473,0.1,2500000,250,816459
"6546",15156,0.1,8e+05,80,816539
"6547",15091,0.1,9e+05,90,816629
"6548",15621,0.1,4060000,406,817035
"6549",23843,0.1,1190000,119,817154
"6550",15317,0.1,1490000,149,817303
"6551",15251,0.1,1400000,140,817443
"6552",23840,0.1,1290000,129,817572
"6553",15134,0.1,1500000,150,817722
"6554",36268,0.1,8e+05,80,817802
"6555",43788,0.1,7e+05,70,817872
"6556",14921,0.1,4420000,442,818314
"6557",15011,0.1,7e+05,70,818384
"6559",15171,0.1,1190000,119,818503
"6560",23831,0.1,490000,49,818552
"6561",23842,0.1,1360000,136,818688
"6562",43749,0.1,560000,56,818744
"6563",36261,0.1,7e+05,70,818814
"6564",14848,0.1,1e+06,100,818914
"6565",36273,0.1,8e+05,80,818994
"6566",14832,0.1,1900000,190,819184
"6568",23816,0.1,7e+05,70,819254
"6569",15040,0.1,3750000,375,819629
"6570",36175,0.1,1260000,126,819755
"6571",36170,0.1,490000,49,819804
"6572",14724,0.1,7e+05,70,819874
"6573",36209,0.1,1050000,105,819979
"6574",36229,0.1,7e+05,70,820049
"6575",14674,0.1,490000,49,820098
"6576",14850,0.1,1700000,170,820268
"6577",14834,0.1,1050000,105,820373
"6578",43791,0.1,6020000,602,820975
"6579",43739,0.1,490000,49,821024
"6580",43783,0.1,12480000,1248,822272
"6581",14777,0.1,640000,64,822336
"6582",14646,0.1,2260000,226,822562
"6583",36105,0.1,8e+05,80,822642
"6584",36115,0.1,640000,64,822706
"6585",14637,0.1,560000,56,822762
"6586",36184,0.1,8e+05,80,822842
"6587",36242,0.1,2140000,214,823056
"6588",36052,0.1,8e+05,80,823136
"6589",14571,0.1,640000,64,823200
"6590",14669,0.1,560000,56,823256
"6591",14581,0.1,8e+05,80,823336
"6592",36230,0.1,5130000,513,823849
"6593",14554,0.1,8e+05,80,823929
"6594",43732,0.1,560000,56,823985
"6595",43720,0.1,640000,64,824049
"6596",14507,0.1,9e+05,90,824139
"6597",36081,0.1,720000,72,824211
"6598",43740,0.1,630000,63,824274
"6599",14566,0.1,2230000,223,824497
"6600",36055,0.1,720000,72,824569
"6601",14475,0.1,9e+05,90,824659
"6602",14515,0.1,720000,72,824731
"6603",36073,0.1,630000,63,824794
"6604",35987,0.1,9e+05,90,824884
"6606",36004,0.1,630000,63,824947
"6607",14485,0.1,9e+05,90,825037
"6608",14430,0.1,1430000,143,825180
"6609",36092,0.1,1850000,185,825365
"6610",14406,0.1,630000,63,825428
"6611",43713,0.1,720000,72,825500
"6612",14368,0.1,810000,81,825581
"6613",14335,0.1,560000,56,825637
"6614",14348,0.1,8e+05,80,825717
"6615",14390,0.1,1200000,120,825837
"6616",43742,0.1,2690000,269,826106
"6617",14334,0.1,1120000,112,826218
"6618",43734,0.1,1440000,144,826362
"6619",14455,0.1,1120000,112,826474
"6620",36003,0.1,8e+05,80,826554
"6621",14847,0.1,2550000,255,826809
"6622",36222,0.1,5640000,564,827373
"6623",14573,0.1,2820000,282,827655
"6624",36059,0.1,1990000,199,827854
"6625",14326,0.1,560000,56,827910
"6626",35939,0.1,560000,56,827966
"6627",14500,0.1,2290000,229,828195
"6628",14360,0.1,5100000,510,828705
"6629",14314,0.1,560000,56,828761
"6630",14344,0.1,1440000,144,828905
"6631",14382,0.1,2450000,245,829150
"6632",35953,0.1,1290000,129,829279
"6633",14579,0.1,3060000,306,829585
"6634",35907,0.1,560000,56,829641
"6635",14300,0.1,2630000,263,829904
"6636",35916,0.1,1050000,105,830009
"6637",35974,0.1,560000,56,830065
"6638",14422,0.1,640000,64,830129
"6639",14261,0.1,8e+05,80,830209
"6640",35978,0.1,3530000,353,830562
"6641",43724,0.1,5690000,569,831131
"6642",43715,0.1,560000,56,831187
"6645",43701,0.1,560000,56,831243
"6646",14657,0.1,490000,49,831292
"6647",35992,0.1,490000,49,831341
"6648",14479,0.1,7e+05,70,831411
"6649",14298,0.1,1260000,126,831537
"6650",14313,0.1,1500000,150,831687
"6651",14303,0.1,1050000,105,831792
"6652",14447,0.1,1200000,120,831912
"6653",35935,0.1,1750000,175,832087
"6654",14324,0.1,560000,56,832143
"6655",14139,0.1,490000,49,832192
"6656",35798,0.1,1260000,126,832318
"6657",14267,0.1,2690000,269,832587
"6658",14618,0.1,5370000,537,833124
"6659",14281,0.1,1050000,105,833229
"6660",43664,0.1,560000,56,833285
"6661",14213,0.1,8e+05,80,833365
"6662",14323,0.1,9e+05,90,833455
"6663",43698,0.1,2750000,275,833730
"6664",14276,0.1,1990000,199,833929
"6665",14163,0.1,1e+06,100,834029
"6666",35947,0.1,7e+05,70,834099
"6667",35914,0.1,1190000,119,834218
"6668",35874,0.1,1500000,150,834368
"6669",35759,0.1,1990000,199,834567
"6670",14071,0.1,1e+06,100,834667
"6671",14129,0.1,8e+05,80,834747
"6672",35755,0.1,7e+05,70,834817
"6673",14101,0.1,2360000,236,835053
"6674",35752,0.1,8e+05,80,835133
"6675",14084,0.1,1960000,196,835329
"6676",35787,0.1,3990000,399,835728
"6677",14175,0.1,1360000,136,835864
"6678",35893,0.1,1e+06,100,835964
"6679",14152,0.1,1e+06,100,836064
"6680",35887,0.1,5350000,535,836599
"6682",14114,0.1,2630000,263,836862
"6683",14078,0.1,560000,56,836918
"6684",14067,0.1,490000,49,836967
"6685",14092,0.1,1960000,196,837163
"6686",14168,0.1,1990000,199,837362
"6687",14153,0.1,3060000,306,837668
"6688",14365,0.1,4580000,458,838126
"6689",35881,0.1,490000,49,838175
"6690",35716,0.1,560000,56,838231
"6691",35692,0.1,490000,49,838280
"6692",14051,0.1,2620000,262,838542
"6693",35711,0.1,980000,98,838640
"6694",35679,0.1,7e+05,70,838710
"6695",14147,0.1,7e+05,70,838780
"6696",14160,0.1,2190000,219,838999
"6697",35811,0.1,560000,56,839055
"6698",14055,0.1,1990000,199,839254
"6699",13987,0.1,3910000,391,839645
"6700",14099,0.1,2940000,294,839939
"6701",35784,0.1,6310000,631,840570
"6702",14076,0.1,2380000,238,840808
"6703",14042,0.1,8e+05,80,840888
"6704",43651,0.1,7e+05,70,840958
"6705",43662,0.1,1e+06,100,841058
"6706",35742,0.1,8e+05,80,841138
"6707",35731,0.1,2750000,275,841413
"6708",14081,0.1,8e+05,80,841493
"6709",35932,0.1,6480000,648,842141
"6710",35647,0.1,8e+05,80,842221
"6711",13950,0.1,3440000,344,842565
"6712",14034,0.1,7e+05,70,842635
"6713",14056,0.1,1960000,196,842831
"6714",35733,0.1,2990000,299,843130
"6715",35654,0.1,1700000,170,843300
"6716",13937,0.1,2420000,242,843542
"6717",35660,0.1,2960000,296,843838
"6718",35596,0.1,1800000,180,844018
"6719",35561,0.1,7e+05,70,844088
"6720",13836,0.1,1e+06,100,844188
"6721",13837,0.1,9230000,923,845111
"6722",35726,0.1,2860000,286,845397
"6723",14259,0.1,4690000,469,845866
"6724",35516,0.1,8e+05,80,845946
"6725",35523,0.1,7e+05,70,846016
"6726",13932,0.1,560000,56,846072
"6727",13974,0.1,1130000,113,846185
"6728",35649,0.1,560000,56,846241
"6729",35695,0.1,5260000,526,846767
"6730",14102,0.1,1990000,199,846966
"6731",13954,0.1,490000,49,847015
"6732",35615,0.1,7e+05,70,847085
"6733",13944,0.1,560000,56,847141
"6734",13869,0.1,1190000,119,847260
"6735",35553,0.1,7e+05,70,847330
"6736",35519,0.1,1120000,112,847442
"6737",35623,0.1,1190000,119,847561
"6738",35541,0.1,490000,49,847610
"6739",14022,0.1,1700000,170,847780
"6740",35645,0.1,6040000,604,848384
"6741",35617,0.1,1430000,143,848527
"6742",13982,0.1,1360000,136,848663
"6743",13768,0.1,1130000,113,848776
"6744",13881,0.1,7e+05,70,848846
"6745",35470,0.1,3060000,306,849152
"6746",35528,0.1,7e+05,70,849222
"6747",35508,0.1,4540000,454,849676
"6748",13816,0.1,1340000,134,849810
"6749",14038,0.1,1050000,105,849915
"6750",35761,0.1,2500000,250,850165
"6751",13771,0.1,560000,56,850221
"6752",13934,0.1,8e+05,80,850301
"6753",13988,0.1,640000,64,850365
"6754",35500,0.1,560000,56,850421
"6755",35533,0.1,8e+05,80,850501
"6756",13794,0.1,1640000,164,850665
"6757",13842,0.1,560000,56,850721
"6758",13886,0.1,8e+05,80,850801
"6761",35684,0.1,3290000,329,851130
"6762",35633,0.1,2060000,206,851336
"6763",35741,0.1,4500000,450,851786
"6764",35464,0.1,560000,56,851842
"6765",13776,0.1,3440000,344,852186
"6766",35390,0.1,1e+06,100,852286
"6767",13710,0.1,2e+06,200,852486
"6768",35478,0.1,1e+06,100,852586
"6769",43613,0.1,8e+05,80,852666
"6770",13754,0.1,1e+06,100,852766
"6771",13755,0.1,1500000,150,852916
"6772",13876,0.1,1260000,126,853042
"6773",43616,0.1,2990000,299,853341
"6776",13743,0.1,1260000,126,853467
"6777",13852,0.1,1260000,126,853593
"6778",13790,0.1,2440000,244,853837
"6779",35377,0.1,7e+05,70,853907
"6780",13616,0.1,8e+05,80,853987
"6781",13666,0.1,8e+05,80,854067
"6782",35367,0.1,7e+05,70,854137
"6783",35425,0.1,1800000,180,854317
"6784",35391,0.1,560000,56,854373
"6785",35424,0.1,1700000,170,854543
"6786",35504,0.1,2630000,263,854806
"6787",13762,0.1,490000,49,854855
"6788",35402,0.1,7e+05,70,854925
"6789",13715,0.1,1360000,136,855061
"6790",13784,0.1,1750000,175,855236
"6791",13701,0.1,4300000,430,855666
"6792",13630,0.1,490000,49,855715
"6793",43584,0.1,7e+05,70,855785
"6796",13575,0.1,490000,49,855834
"6797",13752,0.1,1360000,136,855970
"6798",35328,0.1,560000,56,856026
"6799",13559,0.1,490000,49,856075
"6800",35333,0.1,1260000,126,856201
"6801",13618,0.1,2550000,255,856456
"6802",13838,0.1,4190000,419,856875
"6803",13819,0.1,1360000,136,857011
"6804",13487,0.1,1490000,149,857160
"6805",35450,0.1,1530000,153,857313
"6806",35331,0.1,2890000,289,857602
"6807",13452,0.1,1260000,126,857728
"6808",35195,0.1,490000,49,857777
"6809",35340,0.1,1850000,185,857962
"6810",35239,0.1,7e+05,70,858032
"6811",35358,0.1,1360000,136,858168
"6812",13730,0.1,4350000,435,858603
"6813",13500,0.1,7e+05,70,858673
"6814",13552,0.1,8e+05,80,858753
"6815",13458,0.1,4930000,493,859246
"6816",35445,0.1,1890000,189,859435
"6817",35227,0.1,8e+05,80,859515
"6818",35305,0.1,9e+05,90,859605
"6819",13584,0.1,8e+05,80,859685
"6820",35501,0.1,3260000,326,860011
"6821",35401,0.1,1990000,199,860210
"6822",13587,0.1,1560000,156,860366
"6823",35491,0.1,4690000,469,860835
"6824",35245,0.1,1500000,150,860985
"6825",13547,0.1,7e+05,70,861055
"6826",43604,0.1,2500000,250,861305
"6827",43596,0.1,2400000,240,861545
"6828",43597,0.1,2450000,245,861790
"6829",35242,0.1,2310000,231,862021
"6830",13636,0.1,2190000,219,862240
"6831",13420,0.1,8e+05,80,862320
"6833",35268,0.1,1e+06,100,862420
"6834",35293,0.1,1500000,150,862570
"6835",35444,0.1,3890000,389,862959
"6836",13390,0.1,1400000,140,863099
"6837",35252,0.1,8e+05,80,863179
"6838",13529,0.1,2400000,240,863419
"6839",35207,0.1,1700000,170,863589
"6840",35180,0.1,8e+05,80,863669
"6841",35047,0.1,7190000,719,864388
"6842",13386,0.1,1e+06,100,864488
"6843",35155,0.1,8e+05,80,864568
"6844",35529,0.1,11670000,1167,865735
"6845",35420,0.1,1190000,119,865854
"6846",13363,0.1,1050000,105,865959
"6848",13753,0.1,560000,56,866015
"6849",13419,0.1,630000,63,866078
"6850",13532,0.1,560000,56,866134
"6851",13709,0.1,1050000,105,866239
"6852",35308,0.1,7e+05,70,866309
"6853",35249,0.1,560000,56,866365
"6854",13314,0.1,490000,49,866414
"6855",13369,0.1,7e+05,70,866484
"6856",13505,0.1,490000,49,866533
"6857",13316,0.1,490000,49,866582
"6858",43529,0.1,1260000,126,866708
"6859",13520,0.1,560000,56,866764
"6860",43564,0.1,4490000,449,867213
"6861",13300,0.1,560000,56,867269
"6862",13168,0.1,490000,49,867318
"6863",13297,0.1,1050000,105,867423
"6864",43541,0.1,7e+05,70,867493
"6865",13277,0.1,1260000,126,867619
"6866",35199,0.1,490000,49,867668
"6867",13456,0.1,560000,56,867724
"6868",35012,0.1,7e+05,70,867794
"6869",13364,0.1,1190000,119,867913
"6870",35142,0.1,560000,56,867969
"6871",13492,0.1,2400000,240,868209
"6872",13488,0.1,560000,56,868265
"6873",35220,0.1,1990000,199,868464
"6874",13194,0.1,1190000,119,868583
"6875",13260,0.1,1190000,119,868702
"6876",13239,0.1,1190000,119,868821
"6877",13153,0.1,560000,56,868877
"6878",34995,0.1,1500000,150,869027
"6879",13124,0.1,2200000,220,869247
"6880",13157,0.1,490000,49,869296
"6881",13234,0.1,7e+05,70,869366
"6882",13184,0.1,490000,49,869415
"6883",13018,0.1,490000,49,869464
"6884",43534,0.1,7e+05,70,869534
"6885",43502,0.1,560000,56,869590
"6886",43521,0.1,490000,49,869639
"6887",43540,0.1,1400000,140,869779
"6888",43512,0.1,560000,56,869835
"6889",13220,0.1,490000,49,869884
"6890",35130,0.1,7e+05,70,869954
"6891",35183,0.1,2540000,254,870208
"6892",34885,0.1,490000,49,870257
"6893",12950,0.1,1050000,105,870362
"6894",35031,0.1,1120000,112,870474
"6895",34931,0.1,1260000,126,870600
"6896",13020,0.1,490000,49,870649
"6897",43558,0.1,490000,49,870698
"6898",43545,0.1,3740000,374,871072
"6899",43497,0.1,1490000,149,871221
"6900",12798,0.1,1750000,175,871396
"6901",13110,0.1,3400000,340,871736
"6902",12968,0.1,3700000,370,872106
"6903",34900,0.1,1520000,152,872258
"6904",12924,0.1,7e+05,70,872328
"6905",13015,0.1,1e+06,100,872428
"6906",35011,0.1,1190000,119,872547
"6907",13131,0.1,7e+05,70,872617
"6908",35058,0.1,1360000,136,872753
"6909",12839,0.1,7e+05,70,872823
"6910",13167,0.1,1700000,170,872993
"6911",13033,0.1,5040000,504,873497
"6912",13304,0.1,3200000,320,873817
"6913",12754,0.1,7e+05,70,873887
"6914",13408,0.1,2260000,226,874113
"6915",34908,0.1,8e+05,80,874193
"6916",43505,0.1,1640000,164,874357
"6917",43472,0.1,8e+05,80,874437
"6920",13330,0.1,7e+05,70,874507
"6921",12751,0.1,8e+05,80,874587
"6922",12975,0.1,2340000,234,874821
"6923",12706,0.1,7e+05,70,874891
"6924",12837,0.1,8e+05,80,874971
"6925",12959,0.1,2960000,296,875267
"6926",34896,0.1,8e+05,80,875347
"6927",13108,0.1,2400000,240,875587
"6928",13396,0.1,1360000,136,875723
"6929",12962,0.1,7e+05,70,875793
"6930",34962,0.1,2400000,240,876033
"6931",12998,0.1,7e+05,70,876103
"6932",34920,0.1,4650000,465,876568
"6933",12689,0.1,1950000,195,876763
"6934",34881,0.1,560000,56,876819
"6935",12695,0.1,8e+05,80,876899
"6936",34927,0.1,4660000,466,877365
"6937",12892,0.1,560000,56,877421
"6938",34869,0.1,2440000,244,877665
"6939",43508,0.1,1440000,144,877809
"6940",34937,0.1,560000,56,877865
"6941",34763,0.1,560000,56,877921
"6942",34948,0.1,5050000,505,878426
"6943",34694,0.1,560000,56,878482
"6944",43510,0.1,4470000,447,878929
"6945",13051,0.1,1840000,184,879113
"6949",12618,0.1,560000,56,879169
"6952",34904,0.1,8120000,812,879981
"6953",34745,0.1,560000,56,880037
"6954",34690,0.1,1540000,154,880191
"6955",12577,0.1,1830000,183,880374
"6956",34735,0.1,720000,72,880446
"6957",12634,0.1,720000,72,880518
"6960",12460,0.1,6020000,602,881120
"6961",12633,0.1,1190000,119,881239
"6962",12609,0.1,3240000,324,881563
"6963",12496,0.1,720000,72,881635
"6964",34714,0.1,2330000,233,881868
"6965",34672,0.1,1350000,135,882003
"6966",12426,0.1,9e+05,90,882093
"6970",34625,0.1,630000,63,882156
"6972",12625,0.1,2890000,289,882445
"6973",34703,0.1,2400000,240,882685
"6974",34661,0.1,3750000,375,883060
"6975",12492,0.1,720000,72,883132
"6976",43434,0.1,9e+05,90,883222
"6977",12631,0.1,1990000,199,883421
"6978",12529,0.1,7590000,759,884180
"6979",12818,0.1,5400000,540,884720
"6980",12563,0.1,1360000,136,884856
"6981",34715,0.1,6750000,675,885531
"6982",34731,0.1,1990000,199,885730
"6984",12470,0.1,1120000,112,885842
"6985",34648,0.1,1830000,183,886025
"6986",34651,0.1,3270000,327,886352
"6987",34709,0.1,2260000,226,886578
"6988",34707,0.1,560000,56,886634
"6989",12531,0.1,1990000,199,886833
"6990",12323,0.1,1760000,176,887009
"6991",34604,0.1,8e+05,80,887089
"6992",12794,0.1,560000,56,887145
"6993",34810,0.1,3190000,319,887464
"6994",34654,0.1,1360000,136,887600
"6995",12404,0.1,1360000,136,887736
"6996",12316,0.1,8e+05,80,887816
"7000",34552,0.1,560000,56,887872
"7003",34499,0.1,1340000,134,888006
"7004",12279,0.1,1290000,129,888135
"7005",43364,0.1,1260000,126,888261
"7006",12185,0.1,7e+05,70,888331
"7007",34519,0.1,560000,56,888387
"7010",12489,0.1,1830000,183,888570
"7011",12608,0.1,3760000,376,888946
"7012",13014,0.1,2240000,224,889170
"7013",12575,0.1,7e+05,70,889240
"7014",12206,0.1,560000,56,889296
"7015",12285,0.1,490000,49,889345
"7016",34699,0.1,2060000,206,889551
"7017",12283,0.1,7e+05,70,889621
"7018",12246,0.1,560000,56,889677
"7019",34488,0.1,1430000,143,889820
"7020",34602,0.1,3750000,375,890195
"7021",34616,0.1,560000,56,890251
"7022",34529,0.1,1990000,199,890450
"7023",12284,0.1,2390000,239,890689
"7024",12162,0.1,7e+05,70,890759
"7025",12343,0.1,1200000,120,890879
"7029",34442,0.1,490000,49,890928
"7030",34571,0.1,7e+05,70,890998
"7031",34546,0.1,490000,49,891047
"7032",12509,0.1,3850000,385,891432
"7033",12241,0.1,490000,49,891481
"7034",43359,0.1,560000,56,891537
"7035",12305,0.1,1200000,120,891657
"7036",34665,0.1,5900000,590,892247
"7037",12253,0.1,7e+05,70,892317
"7038",12085,0.1,8e+05,80,892397
"7039",34366,0.1,1e+06,100,892497
"7040",12075,0.1,2860000,286,892783
"7041",12282,0.1,9e+05,90,892873
"7042",12415,0.1,1e+06,100,892973
"7043",12265,0.1,1360000,136,893109
"7044",12115,0.1,2060000,206,893315
"7045",34644,0.1,3050000,305,893620
"7046",12107,0.1,8e+05,80,893700
"7047",12076,0.1,1260000,126,893826
"7048",12048,0.1,8e+05,80,893906
"7049",34667,0.1,4600000,460,894366
"7050",12233,0.1,1440000,144,894510
"7051",34395,0.1,1e+06,100,894610
"7052",34308,0.1,8e+05,80,894690
"7053",12219,0.1,2600000,260,894950
"7054",12036,0.1,1e+06,100,895050
"7055",12055,0.1,1500000,150,895200
"7056",12052,0.1,8e+05,80,895280
"7057",12053,0.1,7e+05,70,895350
"7058",34330,0.1,1e+06,100,895450
"7059",12008,0.1,8e+05,80,895530
"7060",12249,0.1,1990000,199,895729
"7061",34469,0.1,2060000,206,895935
"7062",34544,0.1,3840000,384,896319
"7063",34337,0.1,3060000,306,896625
"7064",12007,0.1,8e+05,80,896705
"7065",43342,0.1,1e+06,100,896805
"7066",43347,0.1,4220000,422,897227
"7067",12034,0.1,1700000,170,897397
"7068",12082,0.1,8e+05,80,897477
"7071",12175,0.1,1190000,119,897596
"7072",34462,0.1,1360000,136,897732
"7073",34382,0.1,4410000,441,898173
"7074",34283,0.1,1050000,105,898278
"7075",34698,0.1,1340000,134,898412
"7076",34421,0.1,1830000,183,898595
"7077",34260,0.1,7e+05,70,898665
"7078",34274,0.1,1050000,105,898770
"7079",11965,0.1,1260000,126,898896
"7080",34564,0.1,6630000,663,899559
"7081",34496,0.1,3050000,305,899864
"7082",34528,0.1,1700000,170,900034
"7083",11934,0.1,1190000,119,900153
"7084",34261,0.1,1820000,182,900335
"7085",11949,0.1,490000,49,900384
"7086",34328,0.1,490000,49,900433
"7087",12026,0.1,7e+05,70,900503
"7088",34386,0.1,2260000,226,900729
"7089",12081,0.1,490000,49,900778
"7090",11902,0.1,560000,56,900834
"7091",11926,0.1,490000,49,900883
"7092",34228,0.1,7e+05,70,900953
"7093",34275,0.1,560000,56,901009
"7094",11966,0.1,490000,49,901058
"7095",11931,0.1,1120000,112,901170
"7096",34247,0.1,7e+05,70,901240
"7097",12035,0.1,1190000,119,901359
"7098",34349,0.1,2560000,256,901615
"7099",43346,0.1,1190000,119,901734
"7100",11972,0.1,1280000,128,901862
"7101",43333,0.1,7e+05,70,901932
"7102",43330,0.1,1050000,105,902037
"7103",34254,0.1,560000,56,902093
"7106",11979,0.1,1200000,120,902213
"7107",12017,0.1,1360000,136,902349
"7108",12070,0.1,2800000,280,902629
"7109",34207,0.1,8e+05,80,902709
"7110",34186,0.1,640000,64,902773
"7111",34383,0.1,1050000,105,902878
"7112",11852,0.1,1440000,144,903022
"7113",34157,0.1,8e+05,80,903102
"7114",34204,0.1,1200000,120,903222
"7115",34229,0.1,8e+05,80,903302
"7116",11868,0.1,560000,56,903358
"7117",21552,0.1,8e+05,80,903438
"7118",21562,0.1,640000,64,903502
"7119",34282,0.1,3190000,319,903821
"7120",34197,0.1,640000,64,903885
"7121",12044,0.1,5380000,538,904423
"7122",43318,0.1,640000,64,904487
"7123",11924,0.1,1690000,169,904656
"7124",43324,0.1,8e+05,80,904736
"7125",11893,0.1,640000,64,904800
"7126",34245,0.1,2060000,206,905006
"7127",11826,0.1,640000,64,905070
"7128",34235,0.1,3890000,389,905459
"7130",34161,0.1,720000,72,905531
"7131",11843,0.1,1270000,127,905658
"7132",34322,0.1,9e+05,90,905748
"7133",11770,0.1,720000,72,905820
"7134",11888,0.1,3040000,304,906124
"7135",34205,0.1,3430000,343,906467
"7136",34100,0.1,2250000,225,906692
"7137",21560,0.1,810000,81,906773
"7138",34215,0.1,2720000,272,907045
"7139",34117,0.1,1350000,135,907180
"7140",34189,0.1,1360000,136,907316
"7141",34141,0.1,630000,63,907379
"7142",21548,0.1,9e+05,90,907469
"7143",11691,0.1,720000,72,907541
"7144",11766,0.1,2080000,208,907749
"7145",43301,0.1,810000,81,907830
"7146",43306,0.1,630000,63,907893
"7147",34213,0.1,9e+05,90,907983
"7148",34101,0.1,720000,72,908055
"7149",11668,0.1,630000,63,908118
"7150",34109,0.1,9e+05,90,908208
"7151",11919,0.1,9e+05,90,908298
"7152",34006,0.1,1520000,152,908450
"7153",11656,0.1,640000,64,908514
"7154",34236,0.1,2330000,233,908747
"7155",11781,0.1,720000,72,908819
"7156",34178,0.1,4650000,465,909284
"7157",34060,0.1,1360000,136,909420
"7158",34166,0.1,3450000,345,909765
"7159",34091,0.1,1700000,170,909935
"7160",34206,0.1,640000,64,909999
"7161",34219,0.1,8e+05,80,910079
"7162",34032,0.1,640000,64,910143
"7163",11711,0.1,1360000,136,910279
"7164",34059,0.1,1360000,136,910415
"7165",11823,0.1,8e+05,80,910495
"7166",11633,0.1,2200000,220,910715
"7167",43282,0.1,8e+05,80,910795
"7169",11617,0.1,7920000,792,911587
"7170",34377,0.1,8400000,840,912427
"7171",11556,0.1,2680000,268,912695
"7172",11712,0.1,2260000,226,912921
"7173",34021,0.1,3940000,394,913315
"7174",11651,0.1,1260000,126,913441
"7175",33959,0.1,1700000,170,913611
"7176",11560,0.1,8e+05,80,913691
"7177",11900,0.1,1e+06,100,913791
"7178",11495,0.1,1290000,129,913920
"7179",33952,0.1,7e+05,70,913990
"7180",33955,0.1,1500000,150,914140
"7181",11502,0.1,1490000,149,914289
"7182",34139,0.1,6750000,675,914964
"7183",34034,0.1,1440000,144,915108
"7184",33970,0.1,8e+05,80,915188
"7185",11496,0.1,1e+06,100,915288
"7186",34004,0.1,5620000,562,915850
"7187",43235,0.1,1500000,150,916000
"7188",33936,0.1,1260000,126,916126
"7189",11483,0.1,7e+05,70,916196
"7190",34063,0.1,5410000,541,916737
"7191",33957,0.1,630000,63,916800
"7192",33962,0.1,2260000,226,917026
"7193",11484,0.1,1260000,126,917152
"7194",11422,0.1,6020000,602,917754
"7195",11657,0.1,1260000,126,917880
"7196",11424,0.1,490000,49,917929
"7197",33901,0.1,7e+05,70,917999
"7198",33948,0.1,560000,56,918055
"7199",33914,0.1,3550000,355,918410
"7200",11459,0.1,7e+05,70,918480
"7201",33894,0.1,560000,56,918536
"7202",11382,0.1,490000,49,918585
"7203",33850,0.1,7e+05,70,918655
"7204",33974,0.1,1750000,175,918830
"7205",33915,0.1,1260000,126,918956
"7206",33840,0.1,1750000,175,919131
"7207",33843,0.1,7e+05,70,919201
"7208",11312,0.1,490000,49,919250
"7209",11431,0.1,7e+05,70,919320
"7210",33873,0.1,3880000,388,919708
"7211",11429,0.1,2680000,268,919976
"7212",33911,0.1,2310000,231,920207
"7213",11350,0.1,2760000,276,920483
"7214",11568,0.1,2820000,282,920765
"7215",33755,0.1,1190000,119,920884
"7216",33787,0.1,3240000,324,921208
"7217",33792,0.1,1260000,126,921334
"7218",11596,0.1,1890000,189,921523
"7219",11244,0.1,490000,49,921572
"7220",33909,0.1,1960000,196,921768
"7221",33671,0.1,1890000,189,921957
"7222",33924,0.1,2360000,236,922193
"7223",11406,0.1,2190000,219,922412
"7224",11351,0.1,4250000,425,922837
"7225",33830,0.1,1190000,119,922956
"7226",11578,0.1,3240000,324,923280
"7227",33880,0.1,8e+05,80,923360
"7228",33945,0.1,2890000,289,923649
"7229",11343,0.1,2190000,219,923868
"7230",11489,0.1,8e+05,80,923948
"7231",33829,0.1,1e+06,100,924048
"7232",11311,0.1,1800000,180,924228
"7233",11291,0.1,1400000,140,924368
"7234",11246,0.1,1e+06,100,924468
"7235",11193,0.1,1700000,170,924638
"7236",33659,0.1,3200000,320,924958
"7237",11173,0.1,2410000,241,925199
"7239",11374,0.1,7e+05,70,925269
"7240",33878,0.1,1920000,192,925461
"7241",33590,0.1,6410000,641,926102
"7242",11263,0.1,1190000,119,926221
"7243",33799,0.1,2960000,296,926517
"7244",11170,0.1,3460000,346,926863
"7245",33647,0.1,2980000,298,927161
"7246",33910,0.1,1850000,185,927346
"7247",43161,0.1,490000,49,927395
"7248",43140,0.1,1360000,136,927531
"7252",33711,0.1,2550000,255,927786
"7253",11228,0.1,7e+05,70,927856
"7254",33798,0.1,1560000,156,928012
"7255",33646,0.1,1190000,119,928131
"7256",11089,0.1,1190000,119,928250
"7257",33576,0.1,8e+05,80,928330
"7258",11087,0.1,1e+06,100,928430
"7259",11099,0.1,2160000,216,928646
"7260",11057,0.1,1600000,160,928806
"7261",33506,0.1,1e+06,100,928906
"7262",11166,0.1,2500000,250,929156
"7263",33618,0.1,640000,64,929220
"7264",11136,0.1,2620000,262,929482
"7265",11180,0.1,3e+06,300,929782
"7267",33481,0.1,2820000,282,930064
"7268",11100,0.1,2500000,250,930314
"7269",33499,0.1,560000,56,930370
"7270",11059,0.1,560000,56,930426
"7271",10961,0.1,1260000,126,930552
"7272",33477,0.1,560000,56,930608
"7273",33475,0.1,640000,64,930672
"7274",33562,0.1,2060000,206,930878
"7275",33592,0.1,3300000,330,931208
"7276",10965,0.1,1130000,113,931321
"7277",33408,0.1,560000,56,931377
"7278",33546,0.1,640000,64,931441
"7279",10960,0.1,1600000,160,931601
"7280",33464,0.1,2700000,270,931871
"7281",33480,0.1,2700000,270,932141
"7282",10796,0.1,560000,56,932197
"7283",10840,0.1,8e+05,80,932277
"7284",43092,0.1,640000,64,932341
"7285",43105,0.1,8e+05,80,932421
"7286",33434,0.1,490000,49,932470
"7287",33444,0.1,2060000,206,932676
"7289",10985,0.1,3250000,325,933001
"7290",11310,0.1,8890000,889,933890
"7291",33745,0.1,7020000,702,934592
"7292",11250,0.1,3600000,360,934952
"7293",11169,0.1,1050000,105,935057
"7294",11008,0.1,3190000,319,935376
"7295",33447,0.1,7e+05,70,935446
"7296",10963,0.1,2e+06,200,935646
"7297",10850,0.1,1750000,175,935821
"7298",33390,0.1,560000,56,935877
"7299",43075,0.1,1190000,119,935996
"7300",10718,0.1,560000,56,936052
"7301",43145,0.1,2e+06,200,936252
"7302",43048,0.1,1750000,175,936427
"7303",43147,0.1,3110000,311,936738
"7304",43040,0.1,7e+05,70,936808
"7305",10696,0.1,490000,49,936857
"7306",10936,0.1,3400000,340,937197
"7307",10955,0.1,3690000,369,937566
"7308",10812,0.1,2410000,241,937807
"7309",33310,0.1,1e+06,100,937907
"7310",33335,0.1,7e+05,70,937977
"7311",10772,0.1,1e+06,100,938077
"7312",10756,0.1,8e+05,80,938157
"7313",33342,0.1,7e+05,70,938227
"7314",10801,0.1,1e+06,100,938327
"7315",10868,0.1,1700000,170,938497
"7316",33402,0.1,8e+05,80,938577
"7317",10938,0.1,1990000,199,938776
"7318",33381,0.1,1190000,119,938895
"7319",33296,0.1,1500000,150,939045
"7320",33309,0.1,1e+06,100,939145
"7321",33432,0.1,3110000,311,939456
"7322",33307,0.1,7e+05,70,939526
"7323",10939,0.1,2450000,245,939771
"7324",33268,0.1,2450000,245,940016
"7325",10716,0.1,1190000,119,940135
"7326",43019,0.1,8e+05,80,940215
"7327",33265,0.1,1560000,156,940371
"7328",33294,0.1,1500000,150,940521
"7329",43039,0.1,1460000,146,940667
"7330",10693,0.1,1360000,136,940803
"7331",43013,0.1,7e+05,70,940873
"7332",43018,0.1,1e+06,100,940973
"7333",10657,0.1,8e+05,80,941053
"7334",10701,0.1,1400000,140,941193
"7335",33284,0.1,1e+06,100,941293
"7336",10626,0.1,8e+05,80,941373
"7337",43008,0.1,1e+06,100,941473
"7338",42997,0.1,7e+05,70,941543
"7339",10739,0.1,7e+05,70,941613
"7340",10678,0.1,560000,56,941669
"7341",10682,0.1,490000,49,941718
"7342",10677,0.1,3690000,369,942087
"7343",10694,0.1,490000,49,942136
"7344",33386,0.1,3060000,306,942442
"7345",33468,0.1,4560000,456,942898
"7346",10720,0.1,560000,56,942954
"7347",10654,0.1,1750000,175,943129
"7348",10745,0.1,490000,49,943178
"7349",33286,0.1,1850000,185,943363
"7350",43056,0.1,2190000,219,943582
"7351",10664,0.1,7e+05,70,943652
"7352",10636,0.1,490000,49,943701
"7353",33277,0.1,630000,63,943764
"7354",10606,0.1,1680000,168,943932
"7355",33226,0.1,560000,56,943988
"7356",33214,0.1,560000,56,944044
"7357",10568,0.1,490000,49,944093
"7358",33174,0.1,560000,56,944149
"7359",10539,0.1,7e+05,70,944219
"7360",10533,0.1,1050000,105,944324
"7361",42974,0.1,560000,56,944380
"7362",10520,0.1,7e+05,70,944450
"7363",10519,0.1,490000,49,944499
"7364",43004,0.1,560000,56,944555
"7365",10700,0.1,1120000,112,944667
"7366",10760,0.1,7e+05,70,944737
"7367",10618,0.1,490000,49,944786
"7368",33255,0.1,560000,56,944842
"7369",43026,0.1,7e+05,70,944912
"7370",10743,0.1,980000,98,945010
"7371",10713,0.1,1820000,182,945192
"7372",10624,0.1,7e+05,70,945262
"7373",33292,0.1,980000,98,945360
"7374",10806,0.1,3240000,324,945684
"7375",10581,0.1,490000,49,945733
"7376",33212,0.1,1260000,126,945859
"7377",10602,0.1,7e+05,70,945929
"7378",10523,0.1,7e+05,70,945999
"7379",33290,0.1,5530000,553,946552
"7380",10712,0.1,1260000,126,946678
"7381",10559,0.1,490000,49,946727
"7382",10553,0.1,490000,49,946776
"7383",10540,0.1,1190000,119,946895
"7384",33158,0.1,490000,49,946944
"7385",33126,0.1,2090000,209,947153
"7386",10531,0.1,1260000,126,947279
"7387",10419,0.1,490000,49,947328
"7388",10454,0.1,1500000,150,947478
"7389",10405,0.1,490000,49,947527
"7390",42967,0.1,560000,56,947583
"7391",10665,0.1,1360000,136,947719
"7392",10617,0.1,7e+05,70,947789
"7393",10697,0.1,3940000,394,948183
"7394",10612,0.1,3420000,342,948525
"7395",33350,0.1,7700000,770,949295
"7396",10555,0.1,3580000,358,949653
"7397",33227,0.1,1e+06,100,949753
"7398",10578,0.1,7e+05,70,949823
"7399",10714,0.1,2620000,262,950085
"7400",10522,0.1,7e+05,70,950155
"7401",10583,0.1,8e+05,80,950235
"7402",33216,0.1,1190000,119,950354
"7403",10591,0.1,2850000,285,950639
"7404",10596,0.1,1700000,170,950809
"7405",10482,0.1,1500000,150,950959
"7406",33192,0.1,7e+05,70,951029
"7407",42986,0.1,3110000,311,951340
"7408",33173,0.1,3250000,325,951665
"7409",33183,0.1,7e+05,70,951735
"7410",33175,0.1,2260000,226,951961
"7411",33091,0.1,1e+06,100,952061
"7412",33168,0.1,1500000,150,952211
"7413",10570,0.1,2690000,269,952480
"7414",42956,0.1,1e+06,100,952580
"7415",10500,0.1,1360000,136,952716
"7416",10541,0.1,1440000,144,952860
"7417",33229,0.1,2100000,210,953070
"7418",10514,0.1,560000,56,953126
"7419",33235,0.1,1260000,126,953252
"7420",42983,0.1,1360000,136,953388
"7421",10504,0.1,1800000,180,953568
"7422",33104,0.1,8e+05,80,953648
"7423",10457,0.1,560000,56,953704
"7424",10459,0.1,1440000,144,953848
"7425",10395,0.1,1360000,136,953984
"7426",21406,0.1,2440000,244,954228
"7427",33162,0.1,560000,56,954284
"7428",33053,0.1,560000,56,954340
"7429",33077,0.1,1440000,144,954484
"7430",10469,0.1,1260000,126,954610
"7431",10371,0.1,8e+05,80,954690
"7432",10365,0.1,1920000,192,954882
"7433",33084,0.1,560000,56,954938
"7434",33055,0.1,8e+05,80,955018
"7435",33133,0.1,2e+06,200,955218
"7436",33052,0.1,560000,56,955274
"7437",33143,0.1,2340000,234,955508
"7438",10496,0.1,720000,72,955580
"7439",10552,0.1,640000,64,955644
"7440",33182,0.1,6240000,624,956268
"7441",10437,0.1,640000,64,956332
"7442",33070,0.1,2800000,280,956612
"7443",10427,0.1,2700000,270,956882
"7444",10301,0.1,640000,64,956946
"7445",10341,0.1,640000,64,957010
"7448",42941,0.1,2060000,206,957216
"7449",10446,0.1,3860000,386,957602
"7450",42947,0.1,2060000,206,957808
"7451",42940,0.1,640000,64,957872
"7452",33030,0.1,2260000,226,958098
"7453",10393,0.1,720000,72,958170
"7454",33102,0.1,1700000,170,958340
"7455",33185,0.1,2260000,226,958566
"7456",42944,0.1,2130000,213,958779
"7457",33107,0.1,1360000,136,958915
"7458",33106,0.1,630000,63,958978
"7459",21404,0.1,2330000,233,959211
"7460",21400,0.1,720000,72,959283
"7461",10483,0.1,9e+05,90,959373
"7462",33039,0.1,630000,63,959436
"7463",10353,0.1,720000,72,959508
"7464",10333,0.1,2750000,275,959783
"7465",10329,0.1,9e+05,90,959873
"7466",33054,0.1,2330000,233,960106
"7467",33081,0.1,1270000,127,960233
"7468",10412,0.1,1920000,192,960425
"7469",10511,0.1,3400000,340,960765
"7470",33043,0.1,720000,72,960837
"7471",10292,0.1,1890000,189,961026
"7472",32990,0.1,720000,72,961098
"7473",42950,0.1,1530000,153,961251
"7474",10463,0.1,720000,72,961323
"7475",33111,0.1,2700000,270,961593
"7476",33076,0.1,4190000,419,962012
"7477",10399,0.1,720000,72,962084
"7478",10477,0.1,9e+05,90,962174
"7479",10231,0.1,1520000,152,962326
"7480",33029,0.1,1990000,199,962525
"7481",10275,0.1,720000,72,962597
"7482",32950,0.1,630000,63,962660
"7483",42915,0.1,810000,81,962741
"7484",10244,0.1,720000,72,962813
"7485",10536,0.1,1700000,170,962983
"7486",33285,0.1,6300000,630,963613
"7487",10299,0.1,1290000,129,963742
"7488",33032,0.1,2440000,244,963986
"7489",33108,0.1,1700000,170,964156
"7490",33096,0.1,2550000,255,964411
"7491",32994,0.1,560000,56,964467
"7492",10629,0.1,560000,56,964523
"7493",10255,0.1,640000,64,964587
"7494",10318,0.1,2550000,255,964842
"7495",10252,0.1,1440000,144,964986
"7496",32940,0.1,560000,56,965042
"7497",32979,0.1,8e+05,80,965122
"7498",10317,0.1,1360000,136,965258
"7499",33017,0.1,1190000,119,965377
"7500",10327,0.1,1290000,129,965506
"7501",10403,0.1,2160000,216,965722
"7502",32962,0.1,1750000,175,965897
"7503",10311,0.1,1700000,170,966067
"7504",10326,0.1,1360000,136,966203
"7505",33154,0.1,8e+05,80,966283
"7506",10356,0.1,2390000,239,966522
"7507",10272,0.1,2190000,219,966741
"7508",32958,0.1,560000,56,966797
"7509",32977,0.1,640000,64,966861
"7510",10319,0.1,2420000,242,967103
"7511",33008,0.1,1830000,183,967286
"7512",10285,0.1,640000,64,967350
"7513",32972,0.1,4820000,482,967832
"7514",10185,0.1,8e+05,80,967912
"7515",42912,0.1,560000,56,967968
"7516",10181,0.1,8e+05,80,968048
"7517",32893,0.1,32320000,3232,971280
"7518",10232,0.1,2820000,282,971562
"7519",10201,0.1,1520000,152,971714
"7520",32985,0.1,560000,56,971770
"7521",10352,0.1,1260000,126,971896
"7522",10345,0.1,2310000,231,972127
"7523",10314,0.1,2630000,263,972390
"7524",33186,0.1,5990000,599,972989
"7525",10261,0.1,1200000,120,973109
"7526",10284,0.1,1050000,105,973214
"7527",10229,0.1,490000,49,973263
"7528",10230,0.1,7e+05,70,973333
"7529",33007,0.1,560000,56,973389
"7530",32938,0.1,1690000,169,973558
"7531",10215,0.1,1820000,182,973740
"7532",32911,0.1,2120000,212,973952
"7533",33021,0.1,4610000,461,974413
"7534",10276,0.1,490000,49,974462
"7535",10172,0.1,1050000,105,974567
"7536",10179,0.1,1190000,119,974686
"7537",10161,0.1,1260000,126,974812
"7538",32885,0.1,630000,63,974875
"7539",10288,0.1,1260000,126,975001
"7540",32939,0.1,16250000,1625,976626
"7541",32961,0.1,8410000,841,977467
"7542",32896,0.1,7e+05,70,977537
"7543",42896,0.1,490000,49,977586
"7544",42904,0.1,1900000,190,977776
"7545",32922,0.1,1260000,126,977902
"7546",33130,0.1,1700000,170,978072
"7547",10168,0.1,2e+06,200,978272
"7548",32955,0.1,1190000,119,978391
"7549",10188,0.1,7e+05,70,978461
"7550",10248,0.1,1700000,170,978631
"7551",10202,0.1,1700000,170,978801
"7552",32913,0.1,7e+05,70,978871
"7553",10218,0.1,1850000,185,979056
"7554",32846,0.1,7e+05,70,979126
"7555",10138,0.1,2060000,206,979332
"7556",10128,0.1,2850000,285,979617
"7557",32869,0.1,7e+05,70,979687
"7558",32847,0.1,1560000,156,979843
"7559",33015,0.1,5120000,512,980355
"7560",33012,0.1,4780000,478,980833
"7561",10324,0.1,1e+06,100,980933
"7562",10104,0.1,8e+05,80,981013
"7563",32811,0.1,1700000,170,981183
"7564",10110,0.1,2190000,219,981402
"7565",10106,0.1,1500000,150,981552
"7566",32864,0.1,1800000,180,981732
"7567",32848,0.1,7e+05,70,981802
"7568",33079,0.1,2550000,255,982057
"7569",32790,0.1,7e+05,70,982127
"7570",10171,0.1,8e+05,80,982207
"7571",10242,0.1,1e+06,100,982307
"7572",32921,0.1,4650000,465,982772
"7573",32901,0.1,3530000,353,983125
"7574",10152,0.1,1490000,149,983274
"7575",10135,0.1,560000,56,983330
"7576",10115,0.1,7e+05,70,983400
"7577",33038,0.1,11710000,1171,984571
"7578",10162,0.1,1190000,119,984690
"7579",10173,0.1,1360000,136,984826
"7580",32870,0.1,7e+05,70,984896
"7581",32936,0.1,4320000,432,985328
"7582",32851,0.1,1290000,129,985457
"7583",10146,0.1,560000,56,985513
"7584",32890,0.1,1190000,119,985632
"7585",32902,0.1,1360000,136,985768
"7586",10077,0.1,7e+05,70,985838
"7587",32837,0.1,630000,63,985901
"7588",32858,0.1,1360000,136,986037
"7589",10139,0.1,2940000,294,986331
"7590",10091,0.1,7e+05,70,986401
"7591",10060,0.1,490000,49,986450
"7592",10207,0.1,2400000,240,986690
"7593",10210,0.1,2410000,241,986931
"7594",32814,0.1,560000,56,986987
"7595",10099,0.1,2890000,289,987276
"7596",32839,0.1,1750000,175,987451
"7597",32715,0.1,7e+05,70,987521
"7598",32898,0.1,2560000,256,987777
"7599",32739,0.1,490000,49,987826
"7600",10012,0.1,630000,63,987889
"7601",10009,0.1,560000,56,987945
"7602",32855,0.1,3350000,335,988280
"7603",10052,0.1,1400000,140,988420
"7604",10018,0.1,1260000,126,988546
"7605",10014,0.1,1e+06,100,988646
"7606",10058,0.1,1500000,150,988796
"7607",32719,0.1,1490000,149,988945
"7608",32779,0.1,1990000,199,989144
"7609",32703,0.1,5110000,511,989655
"7610",32748,0.1,2500000,250,989905
"7611",42938,0.1,1190000,119,990024
"7612",42898,0.1,1e+06,100,990124
"7613",10087,0.1,2060000,206,990330
"7614",32908,0.1,8e+05,80,990410
"7615",32880,0.1,1890000,189,990599
"7616",32820,0.1,1700000,170,990769
"7617",32705,0.1,8e+05,80,990849
"7618",10034,0.1,7e+05,70,990919
"7619",32731,0.1,8e+05,80,990999
"7620",32784,0.1,3450000,345,991344
"7621",32657,0.1,8e+05,80,991424
"7622",9927,0.1,1e+06,100,991524
"7623",32724,0.1,1800000,180,991704
"7624",32712,0.1,2260000,226,991930
"7625",32726,0.1,1290000,129,992059
"7626",32755,0.1,490000,49,992108
"7627",32662,0.1,1920000,192,992300
"7628",10020,0.1,7e+05,70,992370
"7629",10051,0.1,2650000,265,992635
"7630",10008,0.1,2190000,219,992854
"7631",10001,0.1,560000,56,992910
"7632",9906,0.1,490000,49,992959
"7633",10053,0.1,7e+05,70,993029
"7634",42905,0.1,1360000,136,993165
"7635",42855,0.1,490000,49,993214
"7636",32685,0.1,2060000,206,993420
"7637",9947,0.1,1190000,119,993539
"7638",32642,0.1,1830000,183,993722
"7639",32707,0.1,2550000,255,993977
"7640",32668,0.1,560000,56,994033
"7641",42870,0.1,640000,64,994097
"7642",32714,0.1,1500000,150,994247
"7643",9957,0.1,1440000,144,994391
"7644",32746,0.1,4160000,416,994807
"7645",10004,0.1,4290000,429,995236
"7646",32699,0.1,1500000,150,995386
"7647",42876,0.1,640000,64,995450
"7648",42850,0.1,8e+05,80,995530
"7649",9937,0.1,640000,64,995594
"7650",42872,0.1,1500000,150,995744
"7651",9992,0.1,640000,64,995808
"7652",32634,0.1,3090000,309,996117
"7653",32534,0.1,1340000,134,996251
"7654",32610,0.1,3750000,375,996626
"7655",9710,0.1,640000,64,996690
"7656",32372,0.1,1280000,128,996818
"7657",9628,0.1,2170000,217,997035
"7658",9860,0.1,1260000,126,997161
"7659",42846,0.1,8e+05,80,997241
"7660",32568,0.1,1e+06,100,997341
"7661",32419,0.1,8e+05,80,997421
"7662",9831,0.1,8e+05,80,997501
"7663",9838,0.1,1260000,126,997627
"7664",9748,0.1,1e+06,100,997727
"7665",42837,0.1,8e+05,80,997807
"7666",32693,0.1,3010000,301,998108
"7667",32974,0.1,13340000,1334,999442
"7668",32474,0.1,1260000,126,999568
"7669",9685,0.1,1e+06,100,999668
"7670",9925,0.1,8e+05,80,999748
"7671",32463,0.1,1500000,150,999898
"7672",9737,0.1,7e+05,70,999968
"7673",32489,0.1,1190000,119,1000087
"7674",32488,0.1,1700000,170,1000257
"7675",32559,0.1,1990000,199,1000456
"7676",32462,0.1,1560000,156,1000612
"7677",9709,0.1,2990000,299,1000911
"7678",32279,0.1,3310000,331,1001242
"7679",32468,0.1,1490000,149,1001391
"7680",42835,0.1,1700000,170,1001561
"7681",42841,0.1,560000,56,1001617
"7682",9504,0.1,1490000,149,1001766
"7683",42826,0.1,7e+05,70,1001836
"7684",9796,0.1,490000,49,1001885
"7685",42840,0.1,4320000,432,1002317
"7686",9500,0.1,560000,56,1002373
"7687",32269,0.1,1290000,129,1002502
"7688",9996,0.1,1700000,170,1002672
"7689",32257,0.1,490000,49,1002721
"7690",9479,0.1,560000,56,1002777
"7691",9373,0.1,7e+05,70,1002847
"7692",9472,0.1,490000,49,1002896
"7693",32254,0.1,7e+05,70,1002966
"7694",9468,0.1,8e+05,80,1003046
"7695",9669,0.1,1190000,119,1003165
"7696",32530,0.1,2550000,255,1003420
"7697",32350,0.1,4060000,406,1003826
"7698",9734,0.1,7e+05,70,1003896
"7699",9510,0.1,2760000,276,1004172
"7700",32259,0.1,8e+05,80,1004252
"7701",42817,0.1,7e+05,70,1004322
"7702",9569,0.1,1360000,136,1004458
"7703",9435,0.1,1700000,170,1004628
"7704",42801,0.1,1500000,150,1004778
"7705",9347,0.1,7e+05,70,1004848
"7706",9459,0.1,7e+05,70,1004918
"7707",32244,0.1,1560000,156,1005074
"7708",32695,0.1,4300000,430,1005504
"7709",32422,0.1,2160000,216,1005720
"7710",32107,0.1,1400000,140,1005860
"7711",32189,0.1,1700000,170,1006030
"7712",32095,0.1,8e+05,80,1006110
"7713",32103,0.1,1e+06,100,1006210
"7714",9311,0.1,7e+05,70,1006280
"7715",9414,0.1,8e+05,80,1006360
"7716",32205,0.1,1750000,175,1006535
"7717",9214,0.1,9e+05,90,1006625
"7718",32251,0.1,1050000,105,1006730
"7719",9732,0.1,3100000,310,1007040
"7720",32412,0.1,490000,49,1007089
"7721",9376,0.1,1360000,136,1007225
"7722",42798,0.1,1190000,119,1007344
"7723",42834,0.1,7e+05,70,1007414
"7724",42818,0.1,1190000,119,1007533
"7725",32161,0.1,7e+05,70,1007603
"7726",32115,0.1,490000,49,1007652
"7727",9274,0.1,560000,56,1007708
"7728",42791,0.1,1190000,119,1007827
"7729",32655,0.1,6440000,644,1008471
"7730",32047,0.1,560000,56,1008527
"7731",32201,0.1,2500000,250,1008777
"7734",9306,0.1,1190000,119,1008896
"7735",9238,0.1,7e+05,70,1008966
"7736",42749,0.1,630000,63,1009029
"7738",9377,0.1,490000,49,1009078
"7739",32182,0.1,1120000,112,1009190
"7740",42771,0.1,630000,63,1009253
"7741",9411,0.1,3150000,315,1009568
"7742",32175,0.1,3960000,396,1009964
"7743",32060,0.1,1490000,149,1010113
"7744",42790,0.1,1120000,112,1010225
"7745",9292,0.1,1190000,119,1010344
"7746",9313,0.1,490000,49,1010393
"7747",32220,0.1,1260000,126,1010519
"7748",42807,0.1,2240000,224,1010743
"7749",42787,0.1,1260000,126,1010869
"7750",9293,0.1,3450000,345,1011214
"7751",32114,0.1,3640000,364,1011578
"7752",42793,0.1,1050000,105,1011683
"7753",32185,0.1,490000,49,1011732
"7754",32067,0.1,1540000,154,1011886
"7755",32069,0.1,1400000,140,1012026
"7756",32064,0.1,2800000,280,1012306
"7757",31965,0.1,3110000,311,1012617
"7759",9221,0.1,1960000,196,1012813
"7760",32056,0.1,490000,49,1012862
"7761",32000,0.1,1260000,126,1012988
"7762",32070,0.1,980000,98,1013086
"7763",9060,0.1,7e+05,70,1013156
"7764",31939,0.1,1750000,175,1013331
"7766",32076,0.1,8e+05,80,1013411
"7767",9143,0.1,1600000,160,1013571
"7768",32110,0.1,2480000,248,1013819
"7769",9288,0.1,1190000,119,1013938
"7770",32203,0.1,1e+06,100,1014038
"7771",32014,0.1,1600000,160,1014198
"7772",32181,0.1,4230000,423,1014621
"7773",9226,0.1,7e+05,70,1014691
"7774",32165,0.1,1920000,192,1014883
"7775",42742,0.1,1700000,170,1015053
"7776",42734,0.1,1990000,199,1015252
"7777",32030,0.1,2030000,203,1015455
"7778",42697,0.1,5510000,551,1016006
"7779",32065,0.1,3460000,346,1016352
"7780",32020,0.1,1190000,119,1016471
"7781",9070,0.1,1e+06,100,1016571
"7782",9233,0.1,8e+05,80,1016651
"7783",8994,0.1,1400000,140,1016791
"7784",32061,0.1,2340000,234,1017025
"7785",9083,0.1,2830000,283,1017308
"7786",8958,0.1,7e+05,70,1017378
"7787",31850,0.1,1800000,180,1017558
"7788",8976,0.1,1500000,150,1017708
"7789",31883,0.1,1800000,180,1017888
"7790",31975,0.1,1270000,127,1018015
"7791",9097,0.1,1840000,184,1018199
"7792",32017,0.1,2e+06,200,1018399
"7793",9115,0.1,8e+05,80,1018479
"7794",8973,0.1,1120000,112,1018591
"7795",8986,0.1,640000,64,1018655
"7796",42757,0.1,5050000,505,1019160
"7797",9231,0.1,640000,64,1019224
"7798",9170,0.1,560000,56,1019280
"7799",32135,0.1,7660000,766,1020046
"7800",9062,0.1,640000,64,1020110
"7801",31853,0.1,560000,56,1020166
"7802",31917,0.1,2440000,244,1020410
"7803",8934,0.1,8e+05,80,1020490
"7804",8901,0.1,8e+05,80,1020570
"7805",8898,0.1,560000,56,1020626
"7806",8850,0.1,560000,56,1020682
"7807",31743,0.1,640000,64,1020746
"7808",31701,0.1,560000,56,1020802
"7809",8969,0.1,8e+05,80,1020882
"7810",31860,0.1,5500000,550,1021432
"7811",31889,0.1,2550000,255,1021687
"7812",31862,0.1,560000,56,1021743
"7813",8970,0.1,2150000,215,1021958
"7814",31968,0.1,5190000,519,1022477
"7815",8837,0.1,490000,49,1022526
"7816",42678,0.1,4690000,469,1022995
"7817",31899,0.1,4050000,405,1023400
"7818",31811,0.1,2460000,246,1023646
"7819",8937,0.1,490000,49,1023695
"7821",31873,0.1,4360000,436,1024131
"7822",8975,0.1,1200000,120,1024251
"7823",31834,0.1,1050000,105,1024356
"7824",31645,0.1,1400000,140,1024496
"7825",31809,0.1,560000,56,1024552
"7826",31710,0.1,490000,49,1024601
"7827",8906,0.1,1850000,185,1024786
"7828",31775,0.1,1260000,126,1024912
"7829",8841,0.1,490000,49,1024961
"7830",8822,0.1,7e+05,70,1025031
"7831",8792,0.1,1050000,105,1025136
"7832",31637,0.1,7e+05,70,1025206
"7833",31760,0.1,2250000,225,1025431
"7834",31622,0.1,7e+05,70,1025501
"7835",8900,0.1,9e+05,90,1025591
"7836",31768,0.1,8e+05,80,1025671
"7837",8863,0.1,8e+05,80,1025751
"7838",42647,0.1,8e+05,80,1025831
"7839",31994,0.1,4580000,458,1026289
"7840",31866,0.1,8e+05,80,1026369
"7841",31854,0.1,1e+06,100,1026469
"7842",8810,0.1,7e+05,70,1026539
"7843",31903,0.1,4090000,409,1026948
"7844",42670,0.1,1360000,136,1027084
"7845",42667,0.1,4050000,405,1027489
"7846",8812,0.1,7e+05,70,1027559
"7847",8913,0.1,8e+05,80,1027639
"7848",42650,0.1,1e+06,100,1027739
"7849",8782,0.1,8e+05,80,1027819
"7850",42636,0.1,7e+05,70,1027889
"7851",9212,0.1,1e+06,100,1027989
"7852",31630,0.1,2260000,226,1028215
"7853",8788,0.1,1990000,199,1028414
"7854",31641,0.1,7e+05,70,1028484
"7855",31706,0.1,2190000,219,1028703
"7856",31808,0.1,3110000,311,1029014
"7857",31818,0.1,2500000,250,1029264
"7858",31635,0.1,1700000,170,1029434
"7859",8791,0.1,7e+05,70,1029504
"7860",8800,0.1,7e+05,70,1029574
"7862",31910,0.1,6350000,635,1030209
"7864",31531,0.1,2690000,269,1030478
"7865",8936,0.1,2800000,280,1030758
"7866",31612,0.1,1260000,126,1030884
"7867",8737,0.1,1e+06,100,1030984
"7868",31538,0.1,8e+05,80,1031064
"7869",8685,0.1,1e+06,100,1031164
"7870",31510,0.1,1500000,150,1031314
"7871",8708,0.1,1e+06,100,1031414
"7872",42562,0.1,1e+06,100,1031514
"7873",8786,0.1,8e+05,80,1031594
"7874",31626,0.1,630000,63,1031657
"7875",8885,0.1,560000,56,1031713
"7876",8760,0.1,490000,49,1031762
"7877",31723,0.1,1700000,170,1031932
"7878",8710,0.1,7e+05,70,1032002
"7879",8860,0.1,1190000,119,1032121
"7880",31579,0.1,7e+05,70,1032191
"7881",9002,0.1,1360000,136,1032327
"7882",31782,0.1,5590000,559,1032886
"7883",42631,0.1,2760000,276,1033162
"7884",31638,0.1,2900000,290,1033452
"7885",31624,0.1,1820000,182,1033634
"7886",42588,0.1,490000,49,1033683
"7887",31574,0.1,3550000,355,1034038
"7888",8676,0.1,1190000,119,1034157
"7889",31544,0.1,560000,56,1034213
"7890",8767,0.1,7e+05,70,1034283
"7891",31614,0.1,2990000,299,1034582
"7892",8771,0.1,1360000,136,1034718
"7893",31651,0.1,2190000,219,1034937
"7894",31490,0.1,560000,56,1034993
"7895",31428,0.1,1960000,196,1035189
"7896",31676,0.1,4490000,449,1035638
"7897",31545,0.1,4690000,469,1036107
"7898",31810,0.1,2400000,240,1036347
"7899",8755,0.1,1490000,149,1036496
"7900",31591,0.1,3760000,376,1036872
"7901",31466,0.1,2240000,224,1037096
"7902",31483,0.1,560000,56,1037152
"7903",8665,0.1,7e+05,70,1037222
"7904",31525,0.1,490000,49,1037271
"7905",8684,0.1,1920000,192,1037463
"7906",8659,0.1,7e+05,70,1037533
"7907",31473,0.1,2190000,219,1037752
"7908",31502,0.1,4110000,411,1038163
"7909",42534,0.1,7e+05,70,1038233
"7910",42528,0.1,560000,56,1038289
"7911",8784,0.1,9e+05,90,1038379
"7912",8669,0.1,1500000,150,1038529
"7913",42693,0.1,3910000,391,1038920
"7914",8731,0.1,2060000,206,1039126
"7915",8744,0.1,1e+06,100,1039226
"7916",8793,0.1,1e+06,100,1039326
"7917",8697,0.1,8e+05,80,1039406
"7918",32229,0.1,1.1e+07,1100,1040506
"7919",8848,0.1,1360000,136,1040642
"7920",31499,0.1,7e+05,70,1040712
"7921",31294,0.1,1490000,149,1040861
"7922",31609,0.1,2160000,216,1041077
"7923",31287,0.1,1e+06,100,1041177
"7924",8583,0.1,7e+05,70,1041247
"7925",8558,0.1,8e+05,80,1041327
"7926",31335,0.1,1e+06,100,1041427
"7929",8698,0.1,7e+05,70,1041497
"7930",31562,0.1,4550000,455,1041952
"7931",31404,0.1,3110000,311,1042263
"7932",31315,0.1,1500000,150,1042413
"7933",31271,0.1,2690000,269,1042682
"7934",31253,0.1,7e+05,70,1042752
"7935",8632,0.1,1850000,185,1042937
"7936",23705,0.1,560000,56,1042993
"7937",8473,0.1,490000,49,1043042
"7938",31372,0.1,560000,56,1043098
"7939",42556,0.1,1700000,170,1043268
"7940",42558,0.1,1360000,136,1043404
"7941",8798,0.1,490000,49,1043453
"7942",31419,0.1,1190000,119,1043572
"7943",42752,0.1,12240000,1224,1044796
"7944",42536,0.1,2260000,226,1045022
"7945",31383,0.1,490000,49,1045071
"7946",32001,0.1,10800000,1080,1046151
"7947",8884,0.1,7e+05,70,1046221
"7948",31225,0.1,1120000,112,1046333
"7949",8612,0.1,1290000,129,1046462
"7950",31530,0.1,3450000,345,1046807
"7951",8402,0.1,560000,56,1046863
"7952",31573,0.1,6630000,663,1047526
"7953",8738,0.1,1500000,150,1047676
"7954",31297,0.1,560000,56,1047732
"7955",8603,0.1,1700000,170,1047902
"7956",31398,0.1,1190000,119,1048021
"7957",31267,0.1,560000,56,1048077
"7958",31370,0.1,7e+05,70,1048147
"7959",8327,0.1,560000,56,1048203
"7960",8394,0.1,7e+05,70,1048273
"7961",8626,0.1,490000,49,1048322
"7963",8280,0.1,560000,56,1048378
"7964",8335,0.1,490000,49,1048427
"7965",31147,0.1,1260000,126,1048553
"7966",31402,0.1,1680000,168,1048721
"7967",8606,0.1,1700000,170,1048891
"7968",8311,0.1,560000,56,1048947
"7969",31283,0.1,3350000,335,1049282
"7970",8598,0.1,1360000,136,1049418
"7971",31495,0.1,3380000,338,1049756
"7972",8672,0.1,1260000,126,1049882
"7973",8654,0.1,2060000,206,1050088
"7974",8694,0.1,2400000,240,1050328
"7975",31158,0.1,490000,49,1050377
"7976",8277,0.1,7e+05,70,1050447
"7977",31174,0.1,490000,49,1050496
"7978",8467,0.1,3680000,368,1050864
"7979",8318,0.1,1330000,133,1050997
"7980",31142,0.1,490000,49,1051046
"7981",31155,0.1,1120000,112,1051158
"7982",31064,0.1,630000,63,1051221
"7983",42557,0.1,4560000,456,1051677
"7984",42569,0.1,4010000,401,1052078
"7985",42463,0.1,8e+05,80,1052158
"7986",8342,0.1,640000,64,1052222
"7987",31560,0.1,1050000,105,1052327
"7988",31371,0.1,8e+05,80,1052407
"7989",8599,0.1,560000,56,1052463
"7990",8403,0.1,560000,56,1052519
"7991",31411,0.1,560000,56,1052575
"7992",8739,0.1,640000,64,1052639
"7993",31459,0.1,2550000,255,1052894
"7994",31223,0.1,640000,64,1052958
"7995",8492,0.1,560000,56,1053014
"7996",31067,0.1,560000,56,1053070
"7997",8227,0.1,640000,64,1053134
"7998",31030,0.1,8e+05,80,1053214
"7999",31149,0.1,1050000,105,1053319
"8000",31078,0.1,640000,64,1053383
"8001",31214,0.1,8e+05,80,1053463
"8002",31096,0.1,560000,56,1053519
"8003",31351,0.1,3840000,384,1053903
"8004",31243,0.1,1050000,105,1054008
"8005",8208,0.1,640000,64,1054072
"8006",8401,0.1,720000,72,1054144
"8007",8237,0.1,640000,64,1054208
"8008",31032,0.1,640000,64,1054272
"8009",8607,0.1,1440000,144,1054416
"8010",8477,0.1,1500000,150,1054566
"8011",8276,0.1,8e+05,80,1054646
"8012",8162,0.1,640000,64,1054710
"8013",8158,0.1,1360000,136,1054846
"8014",8240,0.1,1830000,183,1055029
"8015",8348,0.1,1760000,176,1055205
"8016",8214,0.1,1350000,135,1055340
"8017",8085,0.1,560000,56,1055396
"8018",42423,0.1,8e+05,80,1055476
"8019",8520,0.1,1360000,136,1055612
"8020",31503,0.1,5760000,576,1056188
"8021",31034,0.1,9e+05,90,1056278
"8022",8178,0.1,630000,63,1056341
"8023",31280,0.1,4320000,432,1056773
"8024",31019,0.1,630000,63,1056836
"8025",31198,0.1,14440000,1444,1058280
"8026",8650,0.1,720000,72,1058352
"8027",8376,0.1,630000,63,1058415
"8028",8106,0.1,2660000,266,1058681
"8029",8251,0.1,630000,63,1058744
"8030",8167,0.1,720000,72,1058816
"8031",8082,0.1,1350000,135,1058951
"8032",8098,0.1,720000,72,1059023
"8033",30946,0.1,810000,81,1059104
"8034",30954,0.1,720000,72,1059176
"8035",8247,0.1,1190000,119,1059295
"8036",31089,0.1,1700000,170,1059465
"8037",8241,0.1,2890000,289,1059754
"8038",8110,0.1,720000,72,1059826
"8039",30952,0.1,630000,63,1059889
"8040",30967,0.1,9e+05,90,1059979
"8041",8274,0.1,1520000,152,1060131
"8042",8095,0.1,9e+05,90,1060221
"8043",30979,0.1,630000,63,1060284
"8044",31080,0.1,1620000,162,1060446
"8045",8126,0.1,720000,72,1060518
"8046",8192,0.1,2330000,233,1060751
"8047",31050,0.1,810000,81,1060832
"8048",42396,0.1,2460000,246,1061078
"8049",8121,0.1,1360000,136,1061214
"8050",8160,0.1,560000,56,1061270
"8051",30975,0.1,1280000,128,1061398
"8052",31269,0.1,2630000,263,1061661
"8053",31068,0.1,2080000,208,1061869
"8054",42462,0.1,2500000,250,1062119
"8055",42467,0.1,2e+06,200,1062319
"8056",31137,0.1,4420000,442,1062761
"8057",8118,0.1,2170000,217,1062978
"8058",8069,0.1,640000,64,1063042
"8059",30951,0.1,5470000,547,1063589
"8060",30997,0.1,2090000,209,1063798
"8061",30856,0.1,640000,64,1063862
"8062",30934,0.1,2420000,242,1064104
"8063",30926,0.1,2900000,290,1064394
"8064",30918,0.1,560000,56,1064450
"8065",8035,0.1,640000,64,1064514
"8066",30881,0.1,1360000,136,1064650
"8067",30884,0.1,560000,56,1064706
"8068",30905,0.1,1920000,192,1064898
"8069",7976,0.1,1500000,150,1065048
"8070",8048,0.1,640000,64,1065112
"8071",30876,0.1,1920000,192,1065304
"8072",30870,0.1,8e+05,80,1065384
"8073",30764,0.1,640000,64,1065448
"8074",31121,0.1,3850000,385,1065833
"8075",30917,0.1,1190000,119,1065952
"8076",8011,0.1,8e+05,80,1066032
"8077",8146,0.1,1920000,192,1066224
"8078",8003,0.1,8e+05,80,1066304
"8079",30757,0.1,640000,64,1066368
"8080",30998,0.1,3130000,313,1066681
"8081",8165,0.1,1830000,183,1066864
"8082",30845,0.1,8e+05,80,1066944
"8083",30780,0.1,560000,56,1067000
"8084",30850,0.1,4390000,439,1067439
"8085",8033,0.1,1280000,128,1067567
"8086",8455,0.1,640000,64,1067631
"8087",42392,0.1,1190000,119,1067750
"8088",31000,0.1,720000,72,1067822
"8089",23677,0.1,630000,63,1067885
"8090",8104,0.1,9e+05,90,1067975
"8091",31118,0.1,2890000,289,1068264
"8092",30885,0.1,630000,63,1068327
"8093",8092,0.1,720000,72,1068399
"8094",30932,0.1,2730000,273,1068672
"8095",31178,0.1,9e+05,90,1068762
"8096",8075,0.1,2340000,234,1068996
"8097",7936,0.1,630000,63,1069059
"8098",7850,0.1,720000,72,1069131
"8099",30741,0.1,9e+05,90,1069221
"8100",8090,0.1,630000,63,1069284
"8101",7911,0.1,630000,63,1069347
"8102",30854,0.1,720000,72,1069419
"8103",30694,0.1,810000,81,1069500
"8104",30743,0.1,720000,72,1069572
"8105",7838,0.1,630000,63,1069635
"8106",8056,0.1,1700000,170,1069805
"8107",30592,0.1,630000,63,1069868
"8108",7889,0.1,1350000,135,1070003
"8109",30773,0.1,9e+05,90,1070093
"8110",30798,0.1,2630000,263,1070356
"8111",7988,0.1,9e+05,90,1070446
"8112",30799,0.1,1530000,153,1070599
"8113",7989,0.1,630000,63,1070662
"8114",7880,0.1,720000,72,1070734
"8115",30708,0.1,9e+05,90,1070824
"8116",7949,0.1,1350000,135,1070959
"8117",30646,0.1,9e+05,90,1071049
"8118",30632,0.1,720000,72,1071121
"8119",7877,0.1,9e+05,90,1071211
"8120",31054,0.1,6250000,625,1071836
"8121",7730,0.1,3500000,350,1072186
"8122",30533,0.1,3310000,331,1072517
"8123",7970,0.1,640000,64,1072581
"8124",30809,0.1,560000,56,1072637
"8125",7934,0.1,640000,64,1072701
"8126",8156,0.1,560000,56,1072757
"8127",31168,0.1,8e+05,80,1072837
"8128",8057,0.1,1700000,170,1073007
"8129",8074,0.1,640000,64,1073071
"8130",42386,0.1,3710000,371,1073442
"8131",42364,0.1,8e+05,80,1073522
"8132",8206,0.1,8e+05,80,1073602
"8133",31035,0.1,4250000,425,1074027
"8134",7881,0.1,8e+05,80,1074107
"8135",8351,0.1,8e+05,80,1074187
"8136",30707,0.1,1440000,144,1074331
"8137",30644,0.1,560000,56,1074387
"8138",30738,0.1,2690000,269,1074656
"8139",30904,0.1,2420000,242,1074898
"8140",30513,0.1,640000,64,1074962
"8141",7696,0.1,640000,64,1075026
"8142",7914,0.1,1920000,192,1075218
"8143",30621,0.1,560000,56,1075274
"8144",7701,0.1,640000,64,1075338
"8145",30624,0.1,8e+05,80,1075418
"8146",7631,0.1,560000,56,1075474
"8147",30700,0.1,2340000,234,1075708
"8148",30435,0.1,720000,72,1075780
"8149",30512,0.1,640000,64,1075844
"8150",30472,0.1,8e+05,80,1075924
"8151",30779,0.1,2260000,226,1076150
"8152",30388,0.1,1360000,136,1076286
"8153",7629,0.1,560000,56,1076342
"8154",7574,0.1,560000,56,1076398
"8155",30362,0.1,640000,64,1076462
"8156",30484,0.1,1120000,112,1076574
"8157",7664,0.1,640000,64,1076638
"8158",7821,0.1,8e+05,80,1076718
"8159",30719,0.1,2550000,255,1076973
"8160",7925,0.1,560000,56,1077029
"8161",30441,0.1,640000,64,1077093
"8162",30324,0.1,8e+05,80,1077173
"8163",30923,0.1,1360000,136,1077309
"8164",7755,0.1,630000,63,1077372
"8165",30557,0.1,560000,56,1077428
"8166",30548,0.1,490000,49,1077477
"8167",8064,0.1,1500000,150,1077627
"8168",30731,0.1,560000,56,1077683
"8169",7851,0.1,7e+05,70,1077753
"8170",8006,0.1,560000,56,1077809
"8171",30482,0.1,490000,49,1077858
"8172",7895,0.1,7e+05,70,1077928
"8173",7666,0.1,490000,49,1077977
"8174",42324,0.1,7e+05,70,1078047
"8175",30957,0.1,2410000,241,1078288
"8176",30895,0.1,6150000,615,1078903
"8177",30698,0.1,1350000,135,1079038
"8178",30956,0.1,5140000,514,1079552
"8179",7916,0.1,7e+05,70,1079622
"8180",7948,0.1,1690000,169,1079791
"8181",7468,0.1,560000,56,1079847
"8182",7463,0.1,560000,56,1079903
"8183",30387,0.1,7e+05,70,1079973
"8184",7490,0.1,560000,56,1080029
"8185",30496,0.1,1750000,175,1080204
"8186",30501,0.1,1830000,183,1080387
"8187",30309,0.1,560000,56,1080443
"8188",7800,0.1,2410000,241,1080684
"8189",30679,0.1,3750000,375,1081059
"8190",30272,0.1,560000,56,1081115
"8191",30369,0.1,490000,49,1081164
"8192",7533,0.1,7e+05,70,1081234
"8193",30455,0.1,1850000,185,1081419
"8194",30469,0.1,490000,49,1081468
"8195",7578,0.1,2e+06,200,1081668
"8196",7341,0.1,490000,49,1081717
"8197",7489,0.1,1050000,105,1081822
"8198",30348,0.1,1500000,150,1081972
"8199",7684,0.1,7e+05,70,1082042
"8200",30499,0.1,2690000,269,1082311
"8201",30170,0.1,7e+05,70,1082381
"8202",30241,0.1,490000,49,1082430
"8203",30306,0.1,560000,56,1082486
"8204",30168,0.1,3480000,348,1082834
"8205",7300,0.1,7e+05,70,1082904
"8206",7512,0.1,1e+06,100,1083004
"8208",7799,0.1,1190000,119,1083123
"8209",7761,0.1,1e+06,100,1083223
"8210",30814,0.1,3620000,362,1083585
"8211",30868,0.1,2e+06,200,1083785
"8212",31110,0.1,5990000,599,1084384
"8213",7909,0.1,2e+06,200,1084584
"8214",30256,0.1,9e+05,90,1084674
"8215",7313,0.1,1290000,129,1084803
"8216",7384,0.1,7e+05,70,1084873
"8217",30340,0.1,1800000,180,1085053
"8218",7764,0.1,1400000,140,1085193
"8219",30570,0.1,4040000,404,1085597
"8220",30416,0.1,2260000,226,1085823
"8221",7560,0.1,1990000,199,1086022
"8222",7598,0.1,8e+05,80,1086102
"8223",30471,0.1,2190000,219,1086321
"8224",30219,0.1,7e+05,70,1086391
"8225",7446,0.1,1360000,136,1086527
"8226",30113,0.1,7e+05,70,1086597
"8227",7365,0.1,1e+06,100,1086697
"8228",30317,0.1,8e+05,80,1086777
"8229",7301,0.1,7e+05,70,1086847
"8230",7338,0.1,1800000,180,1087027
"8231",30123,0.1,1400000,140,1087167
"8232",7265,0.1,1e+06,100,1087267
"8233",7222,0.1,1e+06,100,1087367
"8234",7213,0.1,8e+05,80,1087447
"8235",7228,0.1,8e+05,80,1087527
"8236",7302,0.1,1e+06,100,1087627
"8237",7426,0.1,2330000,233,1087860
"8240",7348,0.1,490000,49,1087909
"8241",7315,0.1,490000,49,1087958
"8242",30540,0.1,3550000,355,1088313
"8243",30672,0.1,3100000,310,1088623
"8244",30085,0.1,7e+05,70,1088693
"8245",7223,0.1,560000,56,1088749
"8246",30060,0.1,4110000,411,1089160
"8247",30629,0.1,5300000,530,1089690
"8248",7288,0.1,560000,56,1089746
"8249",30233,0.1,1990000,199,1089945
"8250",29996,0.1,7e+05,70,1090015
"8251",7133,0.1,560000,56,1090071
"8252",7141,0.1,980000,98,1090169
"8253",30010,0.1,560000,56,1090225
"8254",29911,0.1,490000,49,1090274
"8255",30084,0.1,2450000,245,1090519
"8256",29865,0.1,7e+05,70,1090589
"8257",30090,0.1,560000,56,1090645
"8258",30078,0.1,7e+05,70,1090715
"8259",29973,0.1,1750000,175,1090890
"8260",29928,0.1,1430000,143,1091033
"8261",7147,0.1,1120000,112,1091145
"8262",29902,0.1,560000,56,1091201
"8263",7135,0.1,490000,49,1091250
"8264",29778,0.1,7e+05,70,1091320
"8265",29795,0.1,1560000,156,1091476
"8266",29935,0.1,1400000,140,1091616
"8268",30390,0.1,3350000,335,1091951
"8269",29864,0.1,1560000,156,1092107
"8270",7107,0.1,8e+05,80,1092187
"8271",29872,0.1,7e+05,70,1092257
"8272",7202,0.1,2690000,269,1092526
"8273",30157,0.1,3230000,323,1092849
"8274",29939,0.1,7e+05,70,1092919
"8275",30583,0.1,5500000,550,1093469
"8276",7784,0.1,8e+05,80,1093549
"8277",29705,0.1,7e+05,70,1093619
"8278",7007,0.1,1e+06,100,1093719
"8280",29915,0.1,7e+05,70,1093789
"8281",7188,0.1,1700000,170,1093959
"8282",29736,0.1,2200000,220,1094179
"8283",29858,0.1,1800000,180,1094359
"8284",29627,0.1,7e+05,70,1094429
"8285",6883,0.1,8e+05,80,1094509
"8286",6803,0.1,8e+05,80,1094589
"8287",29638,0.1,1e+06,100,1094689
"8289",7763,0.1,1750000,175,1094864
"8290",7033,0.1,2260000,226,1095090
"8291",29780,0.1,630000,63,1095153
"8292",7171,0.1,1990000,199,1095352
"8293",29962,0.1,7e+05,70,1095422
"8294",6949,0.1,490000,49,1095471
"8295",7052,0.1,2890000,289,1095760
"8296",30261,0.1,10060000,1006,1096766
"8297",6913,0.1,7e+05,70,1096836
"8298",29733,0.1,490000,49,1096885
"8299",29532,0.1,7e+05,70,1096955
"8301",29910,0.1,3200000,320,1097275
"8302",7137,0.1,560000,56,1097331
"8303",29556,0.1,490000,49,1097380
"8304",6810,0.1,7e+05,70,1097450
"8305",6783,0.1,490000,49,1097499
"8306",29694,0.1,1700000,170,1097669
"8307",7102,0.1,2380000,238,1097907
"8308",6821,0.1,7e+05,70,1097977
"8309",29566,0.1,560000,56,1098033
"8310",29489,0.1,490000,49,1098082
"8311",7054,0.1,7e+05,70,1098152
"8312",6852,0.1,3260000,326,1098478
"8313",6795,0.1,560000,56,1098534
"8317",29848,0.1,2250000,225,1098759
"8318",29752,0.1,8e+05,80,1098839
"8319",30179,0.1,4150000,415,1099254
"8320",30566,0.1,13480000,1348,1100602
"8321",29720,0.1,640000,64,1100666
"8322",30229,0.1,6070000,607,1101273
"8323",29495,0.1,640000,64,1101337
"8324",29655,0.1,1360000,136,1101473
"8325",6773,0.1,1200000,120,1101593
"8326",6736,0.1,8e+05,80,1101673
"8327",6655,0.1,640000,64,1101737
"8328",6688,0.1,560000,56,1101793
"8329",29567,0.1,1200000,120,1101913
"8330",42200,0.1,8e+05,80,1101993
"8331",42211,0.1,560000,56,1102049
"8332",29678,0.1,3190000,319,1102368
"8333",29833,0.1,2250000,225,1102593
"8334",6615,0.1,560000,56,1102649
"8335",29342,0.1,1290000,129,1102778
"8336",6616,0.1,3780000,378,1103156
"8337",6747,0.1,560000,56,1103212
"8338",6617,0.1,8e+05,80,1103292
"8339",42202,0.1,2550000,255,1103547
"8340",6612,0.1,560000,56,1103603
"8342",29431,0.1,7e+05,70,1103673
"8343",6785,0.1,7e+05,70,1103743
"8344",7000,0.1,8e+05,80,1103823
"8345",29413,0.1,1290000,129,1103952
"8346",6755,0.1,9e+05,90,1104042
"8347",6644,0.1,1e+06,100,1104142
"8348",29789,0.1,5980000,598,1104740
"8349",29587,0.1,1260000,126,1104866
"8350",6894,0.1,1e+06,100,1104966
"8351",6435,0.1,1e+06,100,1105066
"8352",6493,0.1,8e+05,80,1105146
"8354",29162,0.1,1e+06,100,1105246
"8355",6434,0.1,1260000,126,1105372
"8356",42147,0.1,8e+05,80,1105452
"8357",6421,0.1,1e+06,100,1105552
"8358",42160,0.1,7e+05,70,1105622
"8359",42161,0.1,8e+05,80,1105702
"8360",29271,0.1,9e+05,90,1105792
"8361",6510,0.1,2360000,236,1106028
"8362",29585,0.1,5430000,543,1106571
"8364",29618,0.1,5910000,591,1107162
"8365",29446,0.1,1360000,136,1107298
"8366",6601,0.1,1190000,119,1107417
"8367",29276,0.1,560000,56,1107473
"8368",29614,0.1,3140000,314,1107787
"8369",6473,0.1,490000,49,1107836
"8370",6471,0.1,560000,56,1107892
"8371",29757,0.1,5740000,574,1108466
"8372",6511,0.1,630000,63,1108529
"8373",6407,0.1,560000,56,1108585
"8374",29452,0.1,3200000,320,1108905
"8375",29390,0.1,1360000,136,1109041
"8376",29324,0.1,1190000,119,1109160
"8377",29242,0.1,7e+05,70,1109230
"8378",29239,0.1,7e+05,70,1109300
"8379",29247,0.1,490000,49,1109349
"8380",6389,0.1,3950000,395,1109744
"8381",29497,0.1,2550000,255,1109999
"8382",29194,0.1,7e+05,70,1110069
"8383",29099,0.1,490000,49,1110118
"8384",6347,0.1,7e+05,70,1110188
"8385",6420,0.1,7e+05,70,1110258
"8386",29261,0.1,2450000,245,1110503
"8387",6302,0.1,1260000,126,1110629
"8388",29581,0.1,2620000,262,1110891
"8389",6485,0.1,3310000,331,1111222
"8390",6619,0.1,980000,98,1111320
"8391",6337,0.1,560000,56,1111376
"8392",29136,0.1,7e+05,70,1111446
"8393",6724,0.1,490000,49,1111495
"8394",6365,0.1,560000,56,1111551
"8395",42137,0.1,490000,49,1111600
"8396",29172,0.1,1540000,154,1111754
"8397",29157,0.1,490000,49,1111803
"8398",6323,0.1,7e+05,70,1111873
"8399",28986,0.1,7e+05,70,1111943
"8400",6306,0.1,1750000,175,1112118
"8401",42114,0.1,630000,63,1112181
"8402",42133,0.1,1610000,161,1112342
"8403",29002,0.1,1500000,150,1112492
"8404",6176,0.1,1360000,136,1112628
"8405",6180,0.1,1e+06,100,1112728
"8406",29077,0.1,7e+05,70,1112798
"8408",6432,0.1,1700000,170,1112968
"8409",29561,0.1,6820000,682,1113650
"8410",29262,0.1,2650000,265,1113915
"8411",29006,0.1,8e+05,80,1113995
"8412",28916,0.1,1e+06,100,1114095
"8413",6426,0.1,1e+06,100,1114195
"8414",42150,0.1,3080000,308,1114503
"8415",6122,0.1,8e+05,80,1114583
"8416",42045,0.1,9e+05,90,1114673
"8417",42065,0.1,7e+05,70,1114743
"8418",42099,0.1,1e+06,100,1114843
"8419",28996,0.1,3450000,345,1115188
"8420",6046,0.1,7e+05,70,1115258
"8421",29086,0.1,4040000,404,1115662
"8422",6143,0.1,490000,49,1115711
"8423",29047,0.1,1890000,189,1115900
"8424",29055,0.1,1360000,136,1116036
"8425",6085,0.1,7e+05,70,1116106
"8426",6123,0.1,560000,56,1116162
"8427",28976,0.1,1190000,119,1116281
"8428",6341,0.1,1680000,168,1116449
"8429",29113,0.1,3180000,318,1116767
"8430",44283,0.1,4600000,460,1117227
"8431",6074,0.1,560000,56,1117283
"8432",6240,0.1,2990000,299,1117582
"8433",42153,0.1,4300000,430,1118012
"8434",6115,0.1,7e+05,70,1118082
"8435",5985,0.1,2050000,205,1118287
"8436",6022,0.1,630000,63,1118350
"8437",6045,0.1,1360000,136,1118486
"8438",42006,0.1,490000,49,1118535
"8439",5971,0.1,7e+05,70,1118605
"8440",6014,0.1,1260000,126,1118731
"8441",28857,0.1,490000,49,1118780
"8442",28754,0.1,560000,56,1118836
"8443",28825,0.1,7e+05,70,1118906
"8444",28844,0.1,1e+06,100,1119006
"8445",28993,0.1,1190000,119,1119125
"8446",29192,0.1,6900000,690,1119815
"8447",5838,0.1,8e+05,80,1119895
"8448",42017,0.1,1500000,150,1120045
"8449",41926,0.1,1700000,170,1120215
"8450",5805,0.1,2700000,270,1120485
"8451",41923,0.1,1700000,170,1120655
"8452",28712,0.1,1290000,129,1120784
"8453",5865,0.1,3140000,314,1121098
"8454",28670,0.1,2500000,250,1121348
"8455",6032,0.1,560000,56,1121404
"8456",28700,0.1,8e+05,80,1121484
"8457",28938,0.1,4140000,414,1121898
"8458",6116,0.1,8e+05,80,1121978
"8459",6092,0.1,1440000,144,1122122
"8460",41814,0.1,1260000,126,1122248
"8461",41831,0.1,640000,64,1122312
"8462",5880,0.1,2060000,206,1122518
"8463",5863,0.1,560000,56,1122574
"8464",41894,0.1,1210000,121,1122695
"8465",41929,0.1,560000,56,1122751
"8466",28455,0.1,560000,56,1122807
"8467",28656,0.1,490000,49,1122856
"8468",28516,0.1,490000,49,1122905
"8469",28570,0.1,1050000,105,1123010
"8470",28574,0.1,1750000,175,1123185
"8471",29158,0.1,6400000,640,1123825
"8472",44261,0.1,6700000,670,1124495
"8473",6087,0.1,3190000,319,1124814
"8474",5653,0.1,560000,56,1124870
"8475",44263,0.1,3780000,378,1125248
"8476",28447,0.1,7e+05,70,1125318
"8477",5664,0.1,1990000,199,1125517
"8478",5688,0.1,3050000,305,1125822
"8479",28464,0.1,7e+05,70,1125892
"8480",28466,0.1,1200000,120,1126012
"8481",28390,0.1,490000,49,1126061
"8482",42012,0.1,7e+05,70,1126131
"8483",5536,0.1,3480000,348,1126479
"8484",28349,0.1,7e+05,70,1126549
"8485",28413,0.1,8e+05,80,1126629
"8486",28351,0.1,1500000,150,1126779
"8487",5583,0.1,1360000,136,1126915
"8488",5493,0.1,7e+05,70,1126985
"8489",5479,0.1,2200000,220,1127205
"8490",5677,0.1,7e+05,70,1127275
"8491",5691,0.1,2470000,247,1127522
"8492",28442,0.1,560000,56,1127578
"8493",28410,0.1,490000,49,1127627
"8494",29243,0.1,490000,49,1127676
"8495",29036,0.1,8790000,879,1128555
"8496",28279,0.1,560000,56,1128611
"8497",28341,0.1,4200000,420,1129031
"8498",28289,0.1,1290000,129,1129160
"8499",28907,0.1,2260000,226,1129386
"8500",5457,0.1,490000,49,1129435
"8501",5650,0.1,3620000,362,1129797
"8502",41783,0.1,3550000,355,1130152
"8503",41790,0.1,2060000,206,1130358
"8504",5564,0.1,3240000,324,1130682
"8505",28512,0.1,4260000,426,1131108
"8506",28407,0.1,8e+05,80,1131188
"8510",28443,0.1,1750000,175,1131363
"8511",41426,0.1,8e+05,80,1131443
"8513",5518,0.1,2190000,219,1131662
"8514",28045,0.1,560000,56,1131718
"8515",28169,0.1,560000,56,1131774
"8516",28096,0.1,490000,49,1131823
"8517",5169,0.1,560000,56,1131879
"8518",28133,0.1,640000,64,1131943
"8519",41493,0.1,8e+05,80,1132023
"8520",41458,0.1,560000,56,1132079
"8521",5249,0.1,8e+05,80,1132159
"8522",28127,0.1,2260000,226,1132385
"8523",28174,0.1,560000,56,1132441
"8524",28384,0.1,4810000,481,1132922
"8525",28324,0.1,4940000,494,1133416
"8526",28024,0.1,1440000,144,1133560
"8527",5087,0.1,1280000,128,1133688
"8528",41453,0.1,5690000,569,1134257
"8529",28047,0.1,560000,56,1134313
"8531",28097,0.1,9e+05,90,1134403
"8532",28090,0.1,630000,63,1134466
"8533",28210,0.1,720000,72,1134538
"8534",28135,0.1,9e+05,90,1134628
"8535",28042,0.1,630000,63,1134691
"8536",41340,0.1,720000,72,1134763
"8537",28120,0.1,1190000,119,1134882
"8538",27960,0.1,630000,63,1134945
"8539",41241,0.1,1620000,162,1135107
"8540",28030,0.1,720000,72,1135179
"8541",41311,0.1,2340000,234,1135413
"8542",5143,0.1,560000,56,1135469
"8543",28079,0.1,8e+05,80,1135549
"8544",27972,0.1,560000,56,1135605
"8545",27977,0.1,560000,56,1135661
"8546",28017,0.1,2340000,234,1135895
"8547",27966,0.1,8e+05,80,1135975
"8548",41297,0.1,640000,64,1136039
"8549",41288,0.1,720000,72,1136111
"8550",41322,0.1,640000,64,1136175
"8551",41415,0.1,560000,56,1136231
"8552",28048,0.1,8e+05,80,1136311
"8553",41449,0.1,560000,56,1136367
"8554",5047,0.1,1700000,170,1136537
"8555",4986,0.1,7e+05,70,1136607
"8556",27997,0.1,1500000,150,1136757
"8557",41186,0.1,7e+05,70,1136827
"8558",41174,0.1,2060000,206,1137033
"8559",41434,0.1,490000,49,1137082
"8560",28137,0.1,3750000,375,1137457
"8561",4989,0.1,1260000,126,1137583
"8562",27992,0.1,3190000,319,1137902
"8563",28015,0.1,3110000,311,1138213
"8564",5120,0.1,1e+06,100,1138313
"8565",41203,0.1,8e+05,80,1138393
"8566",27890,0.1,3450000,345,1138738
"8567",27949,0.1,2410000,241,1138979
"8568",5079,0.1,7e+05,70,1139049
"8569",41134,0.1,1400000,140,1139189
"8570",28156,0.1,7250000,725,1139914
"8571",41178,0.1,2990000,299,1140213
"8572",29418,0.1,1990000,199,1140412
"8573",27985,0.1,6e+06,600,1141012
"8574",5130,0.1,490000,49,1141061
"8575",41105,0.1,7e+05,70,1141131
"8576",5025,0.1,560000,56,1141187
"8577",27563,0.1,7e+05,70,1141257
"8578",41049,0.1,490000,49,1141306
"8579",41023,0.1,560000,56,1141362
"8580",5161,0.1,490000,49,1141411
"8581",27846,0.1,1190000,119,1141530
"8582",27588,0.1,560000,56,1141586
"8583",41107,0.1,1190000,119,1141705
"8584",4584,0.1,7e+05,70,1141775
"8585",27603,0.1,2060000,206,1141981
"8586",4737,0.1,1e+06,100,1142081
"8587",27500,0.1,7e+05,70,1142151
"8588",27583,0.1,1360000,136,1142287
"8589",40989,0.1,8e+05,80,1142367
"8590",4818,0.1,1190000,119,1142486
"8591",40950,0.1,7e+05,70,1142556
"8592",40973,0.1,8e+05,80,1142636
"8593",41327,0.1,16650000,1665,1144301
"8594",40951,0.1,7e+05,70,1144371
"8595",27513,0.1,1e+06,100,1144471
"8596",27643,0.1,1190000,119,1144590
"8597",27589,0.1,2060000,206,1144796
"8598",27335,0.1,1e+06,100,1144896
"8599",27477,0.1,7e+05,70,1144966
"8600",27487,0.1,8e+05,80,1145046
"8601",40968,0.1,1e+06,100,1145146
"8602",4691,0.1,7e+05,70,1145216
"8603",4323,0.1,1560000,156,1145372
"8604",4621,0.1,1260000,126,1145498
"8605",27350,0.1,1190000,119,1145617
"8606",40940,0.1,1800000,180,1145797
"8607",27529,0.1,1050000,105,1145902
"8608",4711,0.1,490000,49,1145951
"8609",27466,0.1,4250000,425,1146376
"8610",4714,0.1,560000,56,1146432
"8611",40992,0.1,7100000,710,1147142
"8612",40920,0.1,560000,56,1147198
"8613",27474,0.1,560000,56,1147254
"8614",27337,0.1,490000,49,1147303
"8615",27285,0.1,1120000,112,1147415
"8616",27312,0.1,1190000,119,1147534
"8617",27176,0.1,560000,56,1147590
"8618",4442,0.1,490000,49,1147639
"8619",27349,0.1,4740000,474,1148113
"8620",27037,0.1,2250000,225,1148338
"8621",4254,0.1,2630000,263,1148601
"8622",4236,0.1,1260000,126,1148727
"8623",27494,0.1,560000,56,1148783
"8624",4422,0.1,560000,56,1148839
"8625",4752,0.1,560000,56,1148895
"8626",4364,0.1,8e+05,80,1148975
"8627",27121,0.1,2e+06,200,1149175
"8628",4291,0.1,720000,72,1149247
"8629",4244,0.1,640000,64,1149311
"8630",27186,0.1,560000,56,1149367
"8631",4351,0.1,8e+05,80,1149447
"8632",27099,0.1,2630000,263,1149710
"8633",26952,0.1,1360000,136,1149846
"8634",4239,0.1,2060000,206,1150052
"8635",27146,0.1,1800000,180,1150232
"8636",4297,0.1,7e+05,70,1150302
"8637",27145,0.1,1800000,180,1150482
"8638",40867,0.1,7e+05,70,1150552
"8639",40881,0.1,3800000,380,1150932
"8640",40879,0.1,3940000,394,1151326
"8641",40858,0.1,1260000,126,1151452
"8642",27316,0.1,2990000,299,1151751
"8643",26985,0.1,1500000,150,1151901
"8644",4127,0.1,1e+06,100,1152001
"8645",27063,0.1,9e+05,90,1152091
"8646",4045,0.1,1e+06,100,1152191
"8647",3854,0.1,1500000,150,1152341
"8648",27048,0.1,1e+06,100,1152441
"8649",26814,0.1,7e+05,70,1152511
"8650",27077,0.1,490000,49,1152560
"8651",27078,0.1,2e+06,200,1152760
"8652",40786,0.1,1190000,119,1152879
"8653",4475,0.1,560000,56,1152935
"8654",40795,0.1,1890000,189,1153124
"8655",40780,0.1,490000,49,1153173
"8656",26868,0.1,1750000,175,1153348
"8657",3747,0.1,1560000,156,1153504
"8658",26935,0.1,1500000,150,1153654
"8659",4062,0.1,7e+05,70,1153724
"8660",40778,0.1,8e+05,80,1153804
"8661",3826,0.1,7e+05,70,1153874
"8662",26936,0.1,4460000,446,1154320
"8663",27101,0.1,6880000,688,1155008
"8664",26809,0.1,2260000,226,1155234
"8665",26924,0.1,560000,56,1155290
"8666",40753,0.1,1700000,170,1155460
"8667",40704,0.1,490000,49,1155509
"8668",3574,0.1,630000,63,1155572
"8669",26915,0.1,1190000,119,1155691
"8670",26755,0.1,1260000,126,1155817
"8671",3639,0.1,490000,49,1155866
"8672",26720,0.1,560000,56,1155922
"8673",26778,0.1,2240000,224,1156146
"8674",26667,0.1,3460000,346,1156492
"8675",40690,0.1,4740000,474,1156966
"8676",3477,0.1,1630000,163,1157129
"8677",3484,0.1,560000,56,1157185
"8678",3260,0.1,1700000,170,1157355
"8679",3586,0.1,1190000,119,1157474
"8680",26529,0.1,8e+05,80,1157554
"8681",26552,0.1,1200000,120,1157674
"8682",26544,0.1,8e+05,80,1157754
"8683",26507,0.1,560000,56,1157810
"8684",26512,0.1,640000,64,1157874
"8685",3247,0.1,1440000,144,1158018
"8686",26687,0.1,8500000,850,1158868
"8687",3069,0.1,9e+05,90,1158958
"8688",26456,0.1,630000,63,1159021
"8689",3231,0.1,720000,72,1159093
"8690",26450,0.1,720000,72,1159165
"8691",26551,0.1,2390000,239,1159404
"8692",26411,0.1,2530000,253,1159657
"8693",26471,0.1,8e+05,80,1159737
"8694",26405,0.1,1200000,120,1159857
"8695",26485,0.1,2890000,289,1160146
"8696",26393,0.1,1490000,149,1160295
"8697",2998,0.1,630000,63,1160358
"8698",40650,0.1,3420000,342,1160700
"8699",26408,0.1,1050000,105,1160805
"8700",26375,0.1,2060000,206,1161011
"8701",26407,0.1,3500000,350,1161361
"8702",2883,0.1,1e+06,100,1161461
"8703",40605,0.1,3450000,345,1161806
"8704",2764,0.1,7e+05,70,1161876
"8705",2694,0.1,640000,64,1161940
"8706",26281,0.1,6040000,604,1162544
"8707",26292,0.1,8770000,877,1163421
"8708",2676,0.1,9e+05,90,1163511
"8709",26191,0.1,560000,56,1163567
"8710",2523,0.1,7e+05,70,1163637
"8711",26170,0.1,490000,49,1163686
"8712",26199,0.1,1920000,192,1163878
"8713",2132,0.1,1e+06,100,1163978
"8714",26163,0.1,2890000,289,1164267
"8715",26185,0.1,3550000,355,1164622
"8716",26136,0.1,1e+06,100,1164722
"8717",26117,0.1,7e+05,70,1164792
"8718",26123,0.1,490000,49,1164841
"8719",26286,0.1,17350000,1735,1166576
"8720",26120,0.1,2190000,219,1166795
"8721",26119,0.1,2060000,206,1167001
"8722",2071,0.1,7e+05,70,1167071
"8723",26177,0.1,3060000,306,1167377
"8724",1965,0.1,7e+05,70,1167447
"8725",26079,0.1,1800000,180,1167627
"8726",2147,0.1,7e+05,70,1167697
"8727",2101,0.1,1260000,126,1167823
"8728",26076,0.1,1340000,134,1167957
"8729",1946,0.1,8e+05,80,1168037
"8730",26086,0.1,8e+05,80,1168117
"8731",1890,0.1,1440000,144,1168261
"8732",1899,0.1,1200000,120,1168381
"8733",1922,0.1,8e+05,80,1168461
"8734",26140,0.1,5690000,569,1169030
"8735",26152,0.1,9300000,930,1169960
"8737",26133,0.1,4910000,491,1170451
"8738",26096,0.1,2440000,244,1170695
"8739",26001,0.1,560000,56,1170751
"8740",26224,0.1,13720000,1372,1172123
"8741",26016,0.1,3110000,311,1172434
"8742",2077,0.1,1050000,105,1172539
"8743",40117,0.1,3250000,325,1172864
"8744",26063,0.1,1050000,105,1172969
"8745",1852,0.1,7e+05,70,1173039
"8746",1752,0.1,490000,49,1173088
"8747",1732,0.1,7e+05,70,1173158
"8748",1907,0.1,1200000,120,1173278
"8749",1740,0.1,490000,49,1173327
"8750",1771,0.1,7e+05,70,1173397
"8751",40076,0.1,3690000,369,1173766
"8752",25935,0.1,1e+06,100,1173866
"8753",25868,0.1,1e+06,100,1173966
"8754",25985,0.1,1190000,119,1174085
"8755",25983,0.1,1360000,136,1174221
"8756",40018,0.1,1e+06,100,1174321
"8757",40032,0.1,1700000,170,1174491
"8758",25845,0.1,1800000,180,1174671
"8759",1738,0.1,7e+05,70,1174741
"8760",1690,0.1,1e+06,100,1174841
"8761",1720,0.1,8e+05,80,1174921
"8762",1725,0.1,7e+05,70,1174991
"8763",1707,0.1,1e+06,100,1175091
"8764",1703,0.1,7e+05,70,1175161
"8765",40132,0.1,3040000,304,1175465
"8766",39984,0.1,7e+05,70,1175535
"8767",40004,0.1,490000,49,1175584
"8768",25869,0.1,560000,56,1175640
"8769",25848,0.1,1400000,140,1175780
"8770",26032,0.1,5740000,574,1176354
"8771",1878,0.1,7e+05,70,1176424
"8772",25842,0.1,560000,56,1176480
"8773",25786,0.1,7e+05,70,1176550
"8774",39977,0.1,7e+05,70,1176620
"8775",25828,0.1,7e+05,70,1176690
"8776",25840,0.1,1190000,119,1176809
"8777",1608,0.1,560000,56,1176865
"8778",39946,0.1,490000,49,1176914
"8779",1628,0.1,7e+05,70,1176984
"8780",1602,0.1,1e+06,100,1177084
"8781",1722,0.1,7e+05,70,1177154
"8782",25785,0.1,1800000,180,1177334
"8783",1746,0.1,8e+05,80,1177414
"8784",25892,0.1,3450000,345,1177759
"8785",1632,0.1,7e+05,70,1177829
"8786",25764,0.1,8e+05,80,1177909
"8787",25721,0.1,1e+06,100,1178009
"8788",26009,0.1,9390000,939,1178948
"8789",40080,0.1,7240000,724,1179672
"8790",40056,0.1,7800000,780,1180452
"8791",25731,0.1,1960000,196,1180648
"8792",39902,0.1,7e+05,70,1180718
"8793",25898,0.1,8e+05,80,1180798
"8794",1547,0.1,1400000,140,1180938
"8795",1605,0.1,1e+06,100,1181038
"8796",1539,0.1,8e+05,80,1181118
"8797",1500,0.1,560000,56,1181174
"8798",1507,0.1,1690000,169,1181343
"8799",25561,0.1,7e+05,70,1181413
"8800",25560,0.1,490000,49,1181462
"8801",25571,0.1,560000,56,1181518
"8802",39887,0.1,560000,56,1181574
"8803",39891,0.1,630000,63,1181637
"8804",39880,0.1,1120000,112,1181749
"8805",25582,0.1,490000,49,1181798
"8806",1577,0.1,1360000,136,1181934
"8807",25660,0.1,490000,49,1181983
"8808",25588,0.1,2250000,225,1182208
"8809",25557,0.1,560000,56,1182264
"8810",39874,0.1,1770000,177,1182441
"8811",1487,0.1,1270000,127,1182568
"8812",39860,0.1,3450000,345,1182913
"8813",39863,0.1,8e+05,80,1182993
"8814",1459,0.1,8e+05,80,1183073
"8815",1425,0.1,8e+05,80,1183153
"8816",25637,0.1,640000,64,1183217
"8817",25600,0.1,3590000,359,1183576
"8818",25535,0.1,1700000,170,1183746
"8819",39867,0.1,630000,63,1183809
"8820",39873,0.1,3760000,376,1184185
"8821",39808,0.1,720000,72,1184257
"8822",1469,0.1,2720000,272,1184529
"8823",39904,0.1,4070000,407,1184936
"8824",25244,0.1,9e+05,90,1185026
"8825",1349,0.1,8e+05,80,1185106
"8826",25240,0.1,560000,56,1185162
"8827",39782,0.1,1360000,136,1185298
"8829",39818,0.1,1530000,153,1185451
"8830",25509,0.1,3630000,363,1185814
"8831",25169,0.1,560000,56,1185870
"8832",25464,0.1,2470000,247,1186117
"8833",1457,0.1,1700000,170,1186287
"8834",23555,0.1,640000,64,1186351
"8835",25449,0.1,4470000,447,1186798
"8837",25078,0.1,560000,56,1186854
"8838",23573,0.1,4450000,445,1187299
"8839",23481,0.1,490000,49,1187348
"8840",23487,0.1,560000,56,1187404
"8841",25603,0.1,10560000,1056,1188460
"8842",39788,0.1,4190000,419,1188879
"8843",39748,0.1,1530000,153,1189032
"8844",1221,0.1,7e+05,70,1189102
"8845",25242,0.1,1e+06,100,1189202
"8846",23609,0.1,7e+05,70,1189272
"8847",23470,0.1,1e+06,100,1189372
"8848",23478,0.1,8e+05,80,1189452
"8849",23445,0.1,7e+05,70,1189522
"8850",23441,0.1,1e+06,100,1189622
"8851",23465,0.1,7e+05,70,1189692
"8852",23449,0.1,8e+05,80,1189772
"8853",25194,0.1,3740000,374,1190146
"8854",24978,0.1,7e+05,70,1190216
"8855",1361,0.1,1400000,140,1190356
"8856",39747,0.1,2550000,255,1190611
"8857",25109,0.1,1360000,136,1190747
"8858",25048,0.1,490000,49,1190796
"8859",1118,0.1,490000,49,1190845
"8860",24834,0.1,7e+05,70,1190915
"8861",24928,0.1,560000,56,1190971
"8862",1127,0.1,490000,49,1191020
"8863",23422,0.1,7e+05,70,1191090
"8864",1072,0.1,490000,49,1191139
"8865",24869,0.1,560000,56,1191195
"8866",24957,0.1,490000,49,1191244
"8867",39656,0.1,1800000,180,1191424
"8868",39660,0.1,7e+05,70,1191494
"8869",39697,0.1,1850000,185,1191679
"8870",39849,0.1,7800000,780,1192459
"8871",25222,0.1,3330000,333,1192792
"8872",1094,0.1,2260000,226,1193018
"8873",1007,0.1,8e+05,80,1193098
"8874",995,0.1,7e+05,70,1193168
"8875",24746,0.1,1e+06,100,1193268
"8876",24805,0.1,8e+05,80,1193348
"8879",24719,0.1,1e+06,100,1193448
"8881",24734,0.1,1500000,150,1193598
"8882",24818,0.1,1e+06,100,1193698
"8883",1142,0.1,7e+05,70,1193768
"8884",1456,0.1,7e+05,70,1193838
"8885",24918,0.1,3810000,381,1194219
"8886",25235,0.1,12390000,1239,1195458
"8887",24603,0.1,560000,56,1195514
"8888",24527,0.1,1930000,193,1195707
"8889",24689,0.1,1190000,119,1195826
"8890",24546,0.1,560000,56,1195882
"8891",24902,0.1,2400000,240,1196122
"8892",916,0.1,1120000,112,1196234
"8893",989,0.1,560000,56,1196290
"8894",24640,0.1,7e+05,70,1196360
"8895",24509,0.1,490000,49,1196409
"8896",963,0.1,560000,56,1196465
"8897",24675,0.1,7e+05,70,1196535
"8898",39630,0.1,490000,49,1196584
"8901",39621,0.1,1050000,105,1196689
"8902",39607,0.1,1500000,150,1196839
"8903",24460,0.1,3830000,383,1197222
"8904",24598,0.1,1690000,169,1197391
"8905",24577,0.1,1760000,176,1197567
"8906",24876,0.1,5190000,519,1198086
"8907",24454,0.1,560000,56,1198142
"8908",24881,0.1,3540000,354,1198496
"8909",866,0.1,1460000,146,1198642
"8910",24516,0.1,1500000,150,1198792
"8911",24484,0.1,560000,56,1198848
"8912",24389,0.1,640000,64,1198912
"8913",24497,0.1,2e+06,200,1199112
"8914",24501,0.1,8e+05,80,1199192
"8915",39576,0.1,640000,64,1199256
"8916",39531,0.1,8e+05,80,1199336
"8917",39472,0.1,560000,56,1199392
"8919",39486,0.1,560000,56,1199448
"8920",865,0.1,640000,64,1199512
"8921",1010,0.1,3260000,326,1199838
"8922",24432,0.1,630000,63,1199901
"8923",24589,0.1,1700000,170,1200071
"8924",975,0.1,630000,63,1200134
"8925",24548,0.1,2250000,225,1200359
"8926",39428,0.1,720000,72,1200431
"8927",39604,0.1,9e+05,90,1200521
"8928",1092,0.1,1360000,136,1200657
"8929",24340,0.1,630000,63,1200720
"8930",24339,0.1,630000,63,1200783
"8931",24371,0.1,720000,72,1200855
"8932",845,0.1,9e+05,90,1200945
"8933",39569,0.1,1280000,128,1201073
"8934",39572,0.1,2090000,209,1201282
"8935",39432,0.1,720000,72,1201354
"8936",39337,0.1,9e+05,90,1201444
"8940",39339,0.1,630000,63,1201507
"8941",813,0.1,720000,72,1201579
"8942",836,0.1,1700000,170,1201749
"8943",24309,0.1,640000,64,1201813
"8944",24662,0.1,8080000,808,1202621
"8945",24302,0.1,1200000,120,1202741
"8946",39204,0.1,1600000,160,1202901
"8947",39201,0.1,640000,64,1202965
"8948",39199,0.1,8e+05,80,1203045
"8949",39185,0.1,560000,56,1203101
"8950",702,0.1,640000,64,1203165
"8951",39246,0.1,640000,64,1203229
"8952",39215,0.1,1360000,136,1203365
"8953",39167,0.1,640000,64,1203429
"8954",39251,0.1,640000,64,1203493
"8956",893,0.1,7e+05,70,1203563
"8957",24283,0.1,8e+05,80,1203643
"8958",24332,0.1,3620000,362,1204005
"8959",39225,0.1,2500000,250,1204255
"8960",667,0.1,7e+05,70,1204325
"8961",39248,0.1,2360000,236,1204561
"8962",39189,0.1,1800000,180,1204741
"8963",39169,0.1,7e+05,70,1204811
"8964",24304,0.1,2940000,294,1205105
"8965",24273,0.1,1e+06,100,1205205
"8966",24317,0.1,2500000,250,1205455
"8968",24296,0.1,1700000,170,1205625
"8969",24275,0.1,490000,49,1205674
"8970",24306,0.1,5440000,544,1206218
"8971",39150,0.1,1700000,170,1206388
"8972",630,0.1,490000,49,1206437
"8973",39142,0.1,1360000,136,1206573
"8974",39221,0.1,1990000,199,1206772
"8975",39052,0.1,560000,56,1206828
"8976",39030,0.1,7e+05,70,1206898
"8977",39035,0.1,490000,49,1206947
"8978",39033,0.1,560000,56,1207003
"8979",39081,0.1,630000,63,1207066
"8980",668,0.1,490000,49,1207115
"8981",629,0.1,1260000,126,1207241
"8982",24264,0.1,490000,49,1207290
"8984",39348,0.1,9020000,902,1208192
"8985",625,0.1,490000,49,1208241
"8986",39042,0.1,1120000,112,1208353
"8987",39063,0.1,1400000,140,1208493
"8988",39092,0.1,1820000,182,1208675
"8989",39050,0.1,490000,49,1208724
"8990",39058,0.1,560000,56,1208780
"8991",39027,0.1,1890000,189,1208969
"8992",38971,0.1,3550000,355,1209324
"8993",599,0.1,1050000,105,1209429
"8994",554,0.1,630000,63,1209492
"8995",38987,0.1,560000,56,1209548
"8996",24271,0.1,2120000,212,1209760
"8997",657,0.1,1680000,168,1209928
"8998",672,0.1,7e+05,70,1209998
"8999",39120,0.1,2410000,241,1210239
"9000",38945,0.1,1e+06,100,1210339
"9001",24235,0.1,2790000,279,1210618
"9002",586,0.1,1560000,156,1210774
"9003",39083,0.1,1680000,168,1210942
"9004",38928,0.1,8e+05,80,1211022
"9005",38937,0.1,1700000,170,1211192
"9006",38923,0.1,7e+05,70,1211262
"9007",38921,0.1,8e+05,80,1211342
"9008",39013,0.1,2400000,240,1211582
"9009",507,0.1,9e+05,90,1211672
"9010",505,0.1,8e+05,80,1211752
"9011",38920,0.1,7e+05,70,1211822
"9012",38908,0.1,1e+06,100,1211922
"9013",38905,0.1,1850000,185,1212107
"9014",38982,0.1,7e+05,70,1212177
"9015",654,0.1,1e+06,100,1212277
"9016",24265,0.1,7e+05,70,1212347
"9017",24236,0.1,2060000,206,1212553
"9018",24206,0.1,490000,49,1212602
"9019",38902,0.1,560000,56,1212658
"9020",38942,0.1,7e+05,70,1212728
"9021",39032,0.1,5130000,513,1213241
"9022",38865,0.1,3450000,345,1213586
"9023",24255,0.1,6700000,670,1214256
"9024",38903,0.1,490000,49,1214305
"9025",38885,0.1,1260000,126,1214431
"9028",38849,0.1,560000,56,1214487
"9029",38887,0.1,7e+05,70,1214557
"9030",38867,0.1,490000,49,1214606
"9031",38911,0.1,1360000,136,1214742
"9032",459,0.1,630000,63,1214805
"9033",38868,0.1,560000,56,1214861
"9034",24171,0.1,490000,49,1214910
"9035",38898,0.1,1260000,126,1215036
"9036",24202,0.1,490000,49,1215085
"9037",24172,0.1,560000,56,1215141
"9038",38861,0.1,640000,64,1215205
"9039",473,0.1,3300000,330,1215535
"9040",38837,0.1,560000,56,1215591
"9041",24159,0.1,8e+05,80,1215671
"9042",24113,0.1,640000,64,1215735
"9043",38798,0.1,640000,64,1215799
"9044",496,0.1,8e+05,80,1215879
"9047",38808,0.1,8e+05,80,1215959
"9048",38796,0.1,560000,56,1216015
"9049",24114,0.1,8e+05,80,1216095
"9050",24127,0.1,560000,56,1216151
"9051",24105,0.1,640000,64,1216215
"9052",24109,0.1,720000,72,1216287
"9053",24150,0.1,8e+05,80,1216367
"9054",38824,0.1,640000,64,1216431
"9055",38873,0.1,2060000,206,1216637
"9056",481,0.1,2800000,280,1216917
"9057",38814,0.1,1800000,180,1217097
"9058",24097,0.1,8e+05,80,1217177
"9059",404,0.1,7e+05,70,1217247
"9060",24087,0.1,2700000,270,1217517
"9061",24189,0.1,5760000,576,1218093
"9062",38804,0.1,1260000,126,1218219
"9063",379,0.1,7e+05,70,1218289
"9064",38781,0.1,1e+06,100,1218389
"9065",380,0.1,7e+05,70,1218459
"9066",24110,0.1,1e+06,100,1218559
"9067",24073,0.1,9e+05,90,1218649
"9068",24071,0.1,8e+05,80,1218729
"9069",24119,0.1,1900000,190,1218919
"9070",24089,0.1,1e+06,100,1219019
"9071",24080,0.1,1290000,129,1219148
"9072",24099,0.1,1960000,196,1219344
"9073",38791,0.1,2440000,244,1219588
"9074",407,0.1,7e+05,70,1219658
"9075",417,0.1,1800000,180,1219838
"9076",24101,0.1,1260000,126,1219964
"9077",24166,0.1,1750000,175,1220139
"9078",38852,0.1,4980000,498,1220637
"9079",24177,0.1,2090000,209,1220846
"9080",24104,0.1,2760000,276,1221122
"9081",38794,0.1,490000,49,1221171
"9082",38783,0.1,2090000,209,1221380
"9083",398,0.1,7e+05,70,1221450
"9084",38888,0.1,7e+05,70,1221520
"9085",38731,0.1,490000,49,1221569
"9086",38763,0.1,1360000,136,1221705
"9087",38710,0.1,7e+05,70,1221775
"9088",38723,0.1,490000,49,1221824
"9089",38799,0.1,2e+06,200,1222024
"9090",24041,0.1,7e+05,70,1222094
"9091",24040,0.1,490000,49,1222143
"9092",24083,0.1,2060000,206,1222349
"9093",373,0.1,1190000,119,1222468
"9094",38767,0.1,490000,49,1222517
"9095",374,0.1,1400000,140,1222657
"9096",409,0.1,490000,49,1222706
"9097",360,0.1,1120000,112,1222818
"9098",24014,0.1,7e+05,70,1222888
"9099",38789,0.1,8910000,891,1223779
"9100",24055,0.1,3550000,355,1224134
"9101",38727,0.1,1e+06,100,1224234
"9102",24029,0.1,7e+05,70,1224304
"9103",38772,0.1,5350000,535,1224839
"9104",38688,0.1,7e+05,70,1224909
"9105",38713,0.1,8e+05,80,1224989
"9106",38702,0.1,1e+06,100,1225089
"9107",38687,0.1,7e+05,70,1225159
"9108",24026,0.1,8e+05,80,1225239
"9109",347,0.1,1e+06,100,1225339
"9110",24027,0.1,7e+05,70,1225409
"9111",24069,0.1,3550000,355,1225764
"9112",24018,0.1,1800000,180,1225944
"9113",23982,0.1,7e+05,70,1226014
"9114",38726,0.1,1700000,170,1226184
"9115",354,0.1,8e+05,80,1226264
"9116",308,0.1,1500000,150,1226414
"9117",24013,0.1,1e+06,100,1226514
"9118",24061,0.1,1800000,180,1226694
"9119",24019,0.1,3830000,383,1227077
"9120",23954,0.1,560000,56,1227133
"9121",259,0.1,490000,49,1227182
"9122",23983,0.1,490000,49,1227231
"9123",23942,0.1,490000,49,1227280
"9124",23973,0.1,2100000,210,1227490
"9125",23980,0.1,2200000,220,1227710
"9126",24024,0.1,3500000,350,1228060
"9127",23938,0.1,1400000,140,1228200
"9128",256,0.1,1680000,168,1228368
"9129",23949,0.1,7e+05,70,1228438
"9130",233,0.1,560000,56,1228494
"9131",235,0.1,490000,49,1228543
"9132",38656,0.1,1400000,140,1228683
"9133",38666,0.1,560000,56,1228739
"9134",23930,0.1,490000,49,1228788
"9135",23923,0.1,560000,56,1228844
"9136",248,0.1,7e+05,70,1228914
"9137",23947,0.1,7e+05,70,1228984
"9138",251,0.1,490000,49,1229033
"9139",23919,0.1,1700000,170,1229203
"9140",23946,0.1,1920000,192,1229395
"9141",230,0.1,7e+05,70,1229465
"9142",23921,0.1,1e+06,100,1229565
"9143",223,0.1,8e+05,80,1229645
"9144",227,0.1,7e+05,70,1229715
"9145",38635,0.1,1640000,164,1229879
"9146",38632,0.1,1360000,136,1230015
"9147",38651,0.1,1700000,170,1230185
"9148",38636,0.1,7e+05,70,1230255
"9149",38646,0.1,1600000,160,1230415
"9150",220,0.1,1560000,156,1230571
"9151",285,0.1,1190000,119,1230690
"9152",254,0.1,2920000,292,1230982
"9153",212,0.1,8e+05,80,1231062
"9154",38633,0.1,640000,64,1231126
"9155",249,0.1,1800000,180,1231306
"9156",38654,0.1,640000,64,1231370
"9157",203,0.1,560000,56,1231426
"9158",38609,0.1,1520000,152,1231578
"9159",38642,0.1,640000,64,1231642
"9160",38640,0.1,560000,56,1231698
"9161",38625,0.1,8e+05,80,1231778
"9162",38620,0.1,560000,56,1231834
"9163",204,0.1,640000,64,1231898
"9164",38605,0.1,640000,64,1231962
"9165",192,0.1,720000,72,1232034
"9166",219,0.1,1190000,119,1232153
"9167",38581,0.1,9e+05,90,1232243
"9168",38606,0.1,1280000,128,1232371
"9169",188,0.1,630000,63,1232434
"9170",38618,0.1,9e+05,90,1232524
"9171",186,0.1,630000,63,1232587
"9172",197,0.1,1700000,170,1232757
"9173",38592,0.1,720000,72,1232829
"9174",206,0.1,630000,63,1232892
"9175",189,0.1,1350000,135,1233027
"9176",38607,0.1,9e+05,90,1233117
"9177",38577,0.1,720000,72,1233189
"9178",145,0.1,560000,56,1233245
"9179",165,0.1,8e+05,80,1233325
"9180",38557,0.1,640000,64,1233389
"9181",38543,0.1,1900000,190,1233579
"9182",38582,0.1,2e+06,200,1233779
"9183",167,0.1,560000,56,1233835
"9184",38570,0.1,1440000,144,1233979
"9185",158,0.1,1120000,112,1234091
"9186",132,0.1,640000,64,1234155
"9187",97,0.1,7e+05,70,1234225
"9188",38526,0.1,560000,56,1234281
"9189",38541,0.1,1500000,150,1234431
"9190",143,0.1,490000,49,1234480
"9191",205,0.1,1490000,149,1234629
"9192",38621,0.1,4080000,408,1235037
"9193",121,0.1,490000,49,1235086
"9194",123,0.1,560000,56,1235142
"9195",38523,0.1,8e+05,80,1235222
"9196",118,0.1,1190000,119,1235341
"9197",74,0.1,1e+06,100,1235441
"9198",96,0.1,2850000,285,1235726
"9199",38522,0.1,1400000,140,1235866
"9200",90,0.1,8e+05,80,1235946
"9201",38520,0.1,7e+05,70,1236016
"9202",38482,0.1,7e+05,70,1236086
"9203",38524,0.1,2500000,250,1236336
"9204",38478,0.1,7e+05,70,1236406
"9205",63,0.1,1190000,119,1236525
"9206",38477,0.1,560000,56,1236581
"9207",38483,0.1,490000,49,1236630
"9208",38442,0.1,1190000,119,1236749
"9209",38425,0.1,560000,56,1236805
"9210",46,0.1,7e+05,70,1236875
"9211",51,0.1,1800000,180,1237055
"9212",68,0.1,7e+05,70,1237125
"9213",71,0.1,2360000,236,1237361
"9214",38404,0.1,1400000,140,1237501
"9215",38407,0.1,1e+06,100,1237601
"9216",38468,0.1,1190000,119,1237720
"9217",38409,0.1,8e+05,80,1237800
"9218",58,0.1,1e+06,100,1237900
"9219",38434,0.1,560000,56,1237956
"9220",38383,0.1,560000,56,1238012
"9221",23,0.1,490000,49,1238061
"9222",38363,0.1,560000,56,1238117
"9223",19,0.1,560000,56,1238173
"9224",23912,0.1,640000,64,1238237
"9225",29,0.1,3630000,363,1238600
"9226",23905,0.1,8e+05,80,1238680
"9227",16,0.1,1260000,126,1238806
"9228",23910,0.1,2360000,236,1239042
"9229",23875,0.1,7e+05,70,1239112
"9230",23874,0.1,1750000,175,1239287
"9231",10,0.1,1190000,119,1239406
